departement,num_circo,exprimes,nuls,blancs,votants,abstentions,inscrits,nom,nuance,voix,perc_ins,perc_exp,status
01,01,60495,406,929,61830,25013,86843,M. Christophe MAÎTRE,RN,23819,27.43,39.37,Qualif
01,01,60495,406,929,61830,25013,86843,M. Xavier BRETON,LR,14495,16.69,23.96,Qualif
01,01,60495,406,929,61830,25013,86843,M. Sébastien GUERAUD,UG,14188,16.34,23.45,Qualif
01,01,60495,406,929,61830,25013,86843,M. Vincent GUILLERMIN,ENS,7063,8.13,11.68,Battu
01,01,60495,406,929,61830,25013,86843,M. Éric LAHY,EXG,419,0.48,0.69,Battu
01,01,60495,406,929,61830,25013,86843,M. Michael MENDES,DSV,314,0.36,0.52,Battu
01,01,60495,406,929,61830,25013,86843,M. Cyril VINCENT,DSV,197,0.23,0.33,Battu
01,02,71918,321,1197,73436,28438,101874,M. Andréa KOTARAC,RN,28189,27.67,39.2,Qualif
01,02,71918,321,1197,73436,28438,101874,M. Romain DAUBIÉ,ENS,17414,17.09,24.21,Qualif
01,02,71918,321,1197,73436,28438,101874,M. Maxime MEYER,UG,16981,16.67,23.61,Qualif
01,02,71918,321,1197,73436,28438,101874,M. Alexandre NANCHI,LR,6737,6.61,9.37,Battu
01,02,71918,321,1197,73436,28438,101874,M. Olivier EYRAUD,EXD,1863,1.83,2.59,Battu
01,02,71918,321,1197,73436,28438,101874,M. Vincent GOUTAGNY,EXG,734,0.72,1.02,Battu
01,03,53720,381,860,54961,29169,84130,Mme Olga GIVERNET,ENS,17420,20.71,32.43,Qualif
01,03,53720,381,860,54961,29169,84130,Mme Karine DUBARRY,RN,17252,20.51,32.11,Qualif
01,03,53720,381,860,54961,29169,84130,M. Christian JOLIE,UG,13497,16.04,25.12,Qualif
01,03,53720,381,860,54961,29169,84130,Mme Khadija UNAL,LR,3663,4.35,6.82,Battu
01,03,53720,381,860,54961,29169,84130,Mme Annick VEILLEROT,DSV,769,0.91,1.43,Battu
01,03,53720,381,860,54961,29169,84130,M. Fulgence KOUASSI,DIV,630,0.75,1.17,Battu
01,03,53720,381,860,54961,29169,84130,Mme Cécile MAISONNETTE,EXG,455,0.54,0.85,Battu
01,03,53720,381,860,54961,29169,84130,Mme Sofia TONIZZO,DIV,34,0.04,0.06,Battu
01,04,65688,531,1361,67580,28539,96119,M. Jérôme BUISSON,RN,30221,31.44,46.01,Qualif
01,04,65688,531,1361,67580,28539,96119,M. Christophe COQUELET,ENS,14367,14.95,21.87,Qualif
01,04,65688,531,1361,67580,28539,96119,Mme Charline LIOTIER,UG,13113,13.64,19.96,Qualif
01,04,65688,531,1361,67580,28539,96119,M. Guy BILLOUDET,LR,7179,7.47,10.93,Battu
01,04,65688,531,1361,67580,28539,96119,M. Sylvain COUSSON,EXG,706,0.73,1.07,Battu
01,04,65688,531,1361,67580,28539,96119,M. Jérémy NICAUD,DIV,85,0.09,0.13,Battu
01,04,65688,531,1361,67580,28539,96119,M. Yannick BRESSON,DIV,17,0.02,0.03,Battu
01,05,51532,463,978,52973,24927,77900,M. Marc CHAVENT,UXD,20161,25.88,39.12,Qualif
01,05,51532,463,978,52973,24927,77900,Mme Florence PISANI,UG,12542,16.1,24.34,Qualif
01,05,51532,463,978,52973,24927,77900,M. Damien ABAD,DVD,9651,12.39,18.73,Battu
01,05,51532,463,978,52973,24927,77900,Mme Nathalie DESCOURS,ENS,6036,7.75,11.71,Battu
01,05,51532,463,978,52973,24927,77900,M. Fabrice BOURDIN,LR,1623,2.08,3.15,Battu
01,05,51532,463,978,52973,24927,77900,Mme Sylvie CROZET,EXG,606,0.78,1.18,Battu
01,05,51532,463,978,52973,24927,77900,M. Thomas CHATELARD,ECO,484,0.62,0.94,Battu
01,05,51532,463,978,52973,24927,77900,Mme Maria Cristina PATRU,REC,429,0.55,0.83,Battu
02,01,45469,429,1189,47087,24968,72055,M. Nicolas DRAGON,RN,24774,34.38,54.49,Elu
02,01,45469,429,1189,47087,24968,72055,M. Damien DELAVENNE,ENS,10380,14.41,22.83,Battu
02,01,45469,429,1189,47087,24968,72055,M. Charles CULIOLI,UG,8654,12.01,19.03,Battu
02,01,45469,429,1189,47087,24968,72055,M. Jean-Loup PERNELLE,EXG,701,0.97,1.54,Battu
02,01,45469,429,1189,47087,24968,72055,M. Philippe TRÉGUIER,REC,644,0.89,1.42,Battu
02,01,45469,429,1189,47087,24968,72055,M. Matthieu Léon BOUFFLET,DIV,316,0.44,0.69,Battu
02,02,45675,303,716,46694,26471,73165,M. Philippe TORRE,RN,21496,29.38,47.06,Qualif
02,02,45675,303,716,46694,26471,73165,M. Julien DIVE,LR,16288,22.26,35.66,Qualif
02,02,45675,303,716,46694,26471,73165,Mme Anne-Sophie DUJANCOURT,UG,6511,8.9,14.26,Battu
02,02,45675,303,716,46694,26471,73165,M. Didier KACZMAREK,REC,561,0.77,1.23,Battu
02,02,45675,303,716,46694,26471,73165,Mme Corinne BÉCOURT,EXG,497,0.68,1.09,Battu
02,02,45675,303,716,46694,26471,73165,Mme Anne ZANDITÉNAS,EXG,322,0.44,0.7,Battu
02,03,40901,487,952,42340,23648,65988,M. Eddy CASTERMAN,EXD,23577,35.73,57.64,Elu
02,03,40901,487,952,42340,23648,65988,M. Jean-Louis BRICOUT,DVG,15385,23.31,37.62,Battu
02,03,40901,487,952,42340,23648,65988,M. Damien CRÉON,DSV,1165,1.77,2.85,Battu
02,03,40901,487,952,42340,23648,65988,Mme Laetitia VOISIN,EXG,763,1.16,1.87,Battu
02,03,40901,487,952,42340,23648,65988,Mme Anne-Marie FOURNIER,REC,11,0.02,0.03,Battu
02,04,47081,400,992,48473,30463,78936,M. José BEAURAIN,RN,25913,32.83,55.04,Elu
02,04,47081,400,992,48473,30463,78936,M. Benjamin MAURICE,ENS,10448,13.24,22.19,Battu
02,04,47081,400,992,48473,30463,78936,Mme Lola PRIÉ,UG,9335,11.83,19.83,Battu
02,04,47081,400,992,48473,30463,78936,Mme Flora BOUILLAGUET,EXG,832,1.05,1.77,Battu
02,04,47081,400,992,48473,30463,78936,M. Philippe GOUJARD,EXD,553,0.7,1.17,Battu
02,05,52139,743,1029,53911,28600,82511,M. Jocelyn DESSIGNY,RN,27670,33.53,53.07,Elu
02,05,52139,743,1029,53911,28600,82511,Mme Jeanne ROUSSEL,ENS,10811,13.1,20.73,Battu
02,05,52139,743,1029,53911,28600,82511,M. Karim BELAÏD,UG,10272,12.45,19.7,Battu
02,05,52139,743,1029,53911,28600,82511,Mme Jade GILQUIN,LR,2665,3.23,5.11,Battu
02,05,52139,743,1029,53911,28600,82511,Mme Yona MERBOUCHE,EXG,721,0.87,1.38,Battu
03,01,59100,974,1185,61259,27288,88547,Mme Anne-Marie THÈS,RN,22816,25.77,38.61,Qualif
03,01,59100,974,1185,61259,27288,88547,M. Yannick MONNET,UG,17043,19.25,28.84,Qualif
03,01,59100,974,1185,61259,27288,88547,M. Stephane LARZAT,ENS,8811,9.95,14.91,Battu
03,01,59100,974,1185,61259,27288,88547,Mme Alexandra BARDET,LR,7889,8.91,13.35,Battu
03,01,59100,974,1185,61259,27288,88547,M. Jean-Marie GUILLAUMIN,UDI,1303,1.47,2.2,Battu
03,01,59100,974,1185,61259,27288,88547,M. Jean-Marc COLLOT,EXG,636,0.72,1.08,Battu
03,01,59100,974,1185,61259,27288,88547,Mme Blandine AGEZ,REC,602,0.68,1.02,Battu
03,02,51881,1056,1409,54346,25531,79877,M. Jorys BOVET,RN,17810,22.3,34.33,Qualif
03,02,51881,1056,1409,54346,25531,79877,Mme Louise HERITIER,UG,12482,15.63,24.06,Qualif
03,02,51881,1056,1409,54346,25531,79877,M. Romain LEFEBVRE,LR,10204,12.77,19.67,Qualif
03,02,51881,1056,1409,54346,25531,79877,Mme Laurence VANCEUNEBROCK,ENS,6524,8.17,12.57,Battu
03,02,51881,1056,1409,54346,25531,79877,M. Nicolas ROUSSEAUX,DVD,3548,4.44,6.84,Battu
03,02,51881,1056,1409,54346,25531,79877,M. Bernard LEBEL,EXG,802,1,1.55,Battu
03,02,51881,1056,1409,54346,25531,79877,Mme Alice GONÇALVES,REC,511,0.64,0.98,Battu
03,03,53592,709,1011,55312,24756,80068,M. Nicolas RAY,LR,21464,26.81,40.05,Qualif
03,03,53592,709,1011,55312,24756,80068,M. Rémy QUENEY,RN,20270,25.32,37.82,Qualif
03,03,53592,709,1011,55312,24756,80068,Mme Aline JEUDI,UG,10935,13.66,20.4,Qualif
03,03,53592,709,1011,55312,24756,80068,M. Jean-François RAMEAU,EXG,923,1.15,1.72,Battu
04,01,42026,382,871,43279,18194,61473,M. Christian GIRARD,RN,18616,30.28,44.3,Qualif
04,01,42026,382,871,43279,18194,61473,M. Felix BLANC,UG,11457,18.64,27.26,Qualif
04,01,42026,382,871,43279,18194,61473,M. Benoit GAUVAN,ENS,8132,13.23,19.35,Qualif
04,01,42026,382,871,43279,18194,61473,Mme Sandra RAPONI,LR,2956,4.81,7.03,Battu
04,01,42026,382,871,43279,18194,61473,Mme Patricia CAMPART,REC,468,0.76,1.11,Battu
04,01,42026,382,871,43279,18194,61473,Mme Annabel ROS,EXG,396,0.64,0.94,Battu
04,01,42026,382,871,43279,18194,61473,Mme Nadia LAKHLEF TSALAMLAL,UDI,1,0,0,Battu
04,02,44785,480,1295,46560,20111,66671,Mme Sophie VAGINAY,UXD,18314,27.47,40.89,Qualif
04,02,44785,480,1295,46560,20111,66671,M. Léo WALTER,UG,14774,22.16,32.99,Qualif
04,02,44785,480,1295,46560,20111,66671,Mme Dominique BLANC,ENS,10162,15.24,22.69,Qualif
04,02,44785,480,1295,46560,20111,66671,Mme Myriam CADENEL,REC,585,0.88,1.31,Battu
04,02,44785,480,1295,46560,20111,66671,M. Loan REYNAUD,DVD,512,0.77,1.14,Battu
04,02,44785,480,1295,46560,20111,66671,M. Henri CYVOCT,EXG,438,0.66,0.98,Battu
05,01,41244,457,815,42516,17531,60047,M. Jérôme SAINTE-MARIE,RN,15772,26.27,38.24,Qualif
05,01,41244,457,815,42516,17531,60047,Mme Marie-José ALLEMAND,UG,12568,20.93,30.47,Qualif
05,01,41244,457,815,42516,17531,60047,Mme Pascale BOYER,ENS,9312,15.51,22.58,Qualif
05,01,41244,457,815,42516,17531,60047,M. Dorian DEININGER,LR,2949,4.91,7.15,Battu
05,01,41244,457,815,42516,17531,60047,Mme Véronique BUISSON,EXG,643,1.07,1.56,Battu
05,02,38714,301,701,39716,14801,54517,M. Louis ALBRAND,RN,13115,24.06,33.88,Qualif
05,02,38714,301,701,39716,14801,54517,Mme Valérie ROSSI,UG,12661,23.22,32.7,Qualif
05,02,38714,301,701,39716,14801,54517,M. Sébastien FINE,ENS,10338,18.96,26.7,Qualif
05,02,38714,301,701,39716,14801,54517,M. Johann MONDAIN,DIV,2206,4.05,5.7,Battu
05,02,38714,301,701,39716,14801,54517,M. Boris GUIGNARD,EXG,394,0.72,1.02,Battu
06,01,50709,362,667,51738,30141,81879,M. Eric CIOTTI,UXD,20809,25.41,41.04,Qualif
06,01,50709,362,667,51738,30141,81879,M. Olivier SALERNO,UG,13499,16.49,26.62,Qualif
06,01,50709,362,667,51738,30141,81879,M. Graig MONETTI,ENS,11558,14.12,22.79,Qualif
06,01,50709,362,667,51738,30141,81879,M. Virgile VANIER-GUÉRIN,LR,2933,3.58,5.78,Battu
06,01,50709,362,667,51738,30141,81879,Mme Lalla Chama BEN MOULAY,ECO,1427,1.74,2.81,Battu
06,01,50709,362,667,51738,30141,81879,M. Alain LANGOUET,EXG,313,0.38,0.62,Battu
06,01,50709,362,667,51738,30141,81879,M. Jean-Claude Wahid SPACH,REG,136,0.17,0.27,Battu
06,01,50709,362,667,51738,30141,81879,M. Maxime BOVIS,DIV,34,0.04,0.07,Battu
06,02,59641,430,996,61067,29314,90381,M. Lionel TIVOLI,RN,28676,31.73,48.08,Qualif
06,02,59641,430,996,61067,29314,90381,Mme Leïla TONNERRE,UG,11339,12.55,19.01,Qualif
06,02,59641,430,996,61067,29314,90381,M. David VARRONE,ENS,9856,10.9,16.53,Battu
06,02,59641,430,996,61067,29314,90381,M. Simon DARAGON,LR,6162,6.82,10.33,Battu
06,02,59641,430,996,61067,29314,90381,M. Patrice MIRAN,ECO,2296,2.54,3.85,Battu
06,02,59641,430,996,61067,29314,90381,Mme Indiana PORET-RINCK,EXD,931,1.03,1.56,Battu
06,02,59641,430,996,61067,29314,90381,M. Florent IMBERT,EXG,381,0.42,0.64,Battu
06,03,57837,412,763,59012,32712,91724,M. Bernard CHAIX,UXD,23983,26.15,41.47,Qualif
06,03,57837,412,763,59012,32712,91724,Mme Laure QUIGNARD,UG,15754,17.18,27.24,Qualif
06,03,57837,412,763,59012,32712,91724,M. Philippe PRADAL,ENS,14670,15.99,25.36,Qualif
06,03,57837,412,763,59012,32712,91724,Mme Marie Françoise CAUSSIN,ECO,1675,1.83,2.9,Battu
06,03,57837,412,763,59012,32712,91724,M. Thibault DELHEZ,DSV,883,0.96,1.53,Battu
06,03,57837,412,763,59012,32712,91724,Mme Estelle JAQUET,EXG,438,0.48,0.76,Battu
06,03,57837,412,763,59012,32712,91724,Mme Marjorie VIVO,ECO,434,0.47,0.75,Battu
06,04,54249,637,985,55871,29789,85660,Mme Alexandra MASSON,RN,30528,35.64,56.27,Elu
06,04,54249,637,985,55871,29789,85660,Mme Anne-Pascale GUEDON,ENS,11190,13.06,20.63,Battu
06,04,54249,637,985,55871,29789,85660,Mme Virginie PARENT,UG,9861,11.51,18.18,Battu
06,04,54249,637,985,55871,29789,85660,Mme Christine BEYL,ECO,1717,2,3.17,Battu
06,04,54249,637,985,55871,29789,85660,M. Joseph MARKIEL,EXG,953,1.11,1.76,Battu
06,05,59197,503,1114,60814,30418,91232,Mme Christelle D'INTORNI,UXD,29804,32.67,50.35,Elu
06,05,59197,503,1114,60814,30418,91232,M. Fabrice DECOUPIGNY,UG,12233,13.41,20.66,Battu
06,05,59197,503,1114,60814,30418,91232,M. Gaël NOFRI,ENS,8473,9.29,14.31,Battu
06,05,59197,503,1114,60814,30418,91232,M. Patrice BENOIT,DIV,6375,6.99,10.77,Battu
06,05,59197,503,1114,60814,30418,91232,M. Axel HVIDSTEN,ECO,1876,2.06,3.17,Battu
06,05,59197,503,1114,60814,30418,91232,Mme Agnès BENKEMOUN,EXG,436,0.48,0.74,Battu
06,06,54485,231,980,55696,24490,80186,M. Bryan MASSON,RN,27705,34.55,50.85,Elu
06,06,54485,231,980,55696,24490,80186,Mme Laurence TRASTOUR-ISNART,LR,16213,20.22,29.76,Battu
06,06,54485,231,980,55696,24490,80186,Mme Nicole MAZZELLA,UG,8281,10.33,15.2,Battu
06,06,54485,231,980,55696,24490,80186,M. Pierre PIACENTINI,ECO,1927,2.4,3.54,Battu
06,06,54485,231,980,55696,24490,80186,Mme Daniele BARTOLI,EXG,359,0.45,0.66,Battu
06,07,65866,261,761,66888,29396,96284,M. Thierry FERRAND,RN,23921,24.84,36.32,Qualif
06,07,65866,261,761,66888,29396,96284,M. Eric PAUGET,LR,16389,17.02,24.88,Qualif
06,07,65866,261,761,66888,29396,96284,Mme Aline ABRAVANEL,ENS,11510,11.95,17.47,Battu
06,07,65866,261,761,66888,29396,96284,M. Arthur MEYER-ABBATUCCI,UG,10974,11.4,16.66,Battu
06,07,65866,261,761,66888,29396,96284,Mme Marylin ZBIROU,ECO,1651,1.71,2.51,Battu
06,07,65866,261,761,66888,29396,96284,M. David QUINTELA,REC,932,0.97,1.41,Battu
06,07,65866,261,761,66888,29396,96284,M. Christian PETARD,EXG,264,0.27,0.4,Battu
06,07,65866,261,761,66888,29396,96284,M. Enzo DEWASMES,DIV,225,0.23,0.34,Battu
06,08,53836,257,581,54674,29740,84414,Mme Dorette LANDERER,RN,23010,27.26,42.74,Qualif
06,08,53836,257,581,54674,29740,84414,Mme Alexandra MARTIN,LR,15284,18.11,28.39,Qualif
06,08,53836,257,581,54674,29740,84414,Mme Lucia SOUDANT,UG,7837,9.28,14.56,Battu
06,08,53836,257,581,54674,29740,84414,M. Mike CASTRO DEMARIA,ENS,6508,7.71,12.09,Battu
06,08,53836,257,581,54674,29740,84414,Mme Anne ITTY,ECO,950,1.13,1.76,Battu
06,08,53836,257,581,54674,29740,84414,Mme Marie-José PEREIRA,EXG,181,0.21,0.34,Battu
06,08,53836,257,581,54674,29740,84414,M. Christophe NEUTZLER,DIV,66,0.08,0.12,Battu
06,09,54178,237,684,55099,27287,82386,M. Franck GALBERT,RN,22921,27.82,42.31,Qualif
06,09,54178,237,684,55099,27287,82386,Mme Michèle TABAROT,LR,18334,22.25,33.84,Qualif
06,09,54178,237,684,55099,27287,82386,M. José GARCIA ABIA,UG,9987,12.12,18.43,Battu
06,09,54178,237,684,55099,27287,82386,Mme Henriette PALMERS,ECO,1742,2.11,3.22,Battu
06,09,54178,237,684,55099,27287,82386,M. Sylvain LIENHARDT,EXD,900,1.09,1.66,Battu
06,09,54178,237,684,55099,27287,82386,Mme Liliane PÉCOUT,EXG,294,0.36,0.54,Battu
07,01,54412,507,1072,55991,23605,79596,Mme Céline PORQUET,RN,21736,27.31,39.95,Qualif
07,01,54412,507,1072,55991,23605,79596,M. Hervé SAULIGNAC,UG,20809,26.14,38.24,Qualif
07,01,54412,507,1072,55991,23605,79596,Mme Séverine GINEYS,ENS,6651,8.36,12.22,Battu
07,01,54412,507,1072,55991,23605,79596,Mme Marie-Pierre CHAIX,LR,3067,3.85,5.64,Battu
07,01,54412,507,1072,55991,23605,79596,M. Thierry DORNE,DSV,651,0.82,1.2,Battu
07,01,54412,507,1072,55991,23605,79596,Mme Muriel VANDER DONCKT,EXG,518,0.65,0.95,Battu
07,01,54412,507,1072,55991,23605,79596,Mme Maryse LECLERC,REC,506,0.64,0.93,Battu
07,01,54412,507,1072,55991,23605,79596,M. Pascal CHAMBONNET,EXG,474,0.6,0.87,Battu
07,02,68290,694,1420,70404,26734,97138,M. Vincent TREBUCHET,UXD,24417,25.14,35.75,Qualif
07,02,68290,694,1420,70404,26734,97138,Mme Michèle VICTORY,UG,17051,17.55,24.97,Qualif
07,02,68290,694,1420,70404,26734,97138,Mme Laurence HEYDEL GRILLERE,ENS,11904,12.25,17.43,Battu
07,02,68290,694,1420,70404,26734,97138,M. Jean-Paul VALLON,DVD,10509,10.82,15.39,Battu
07,02,68290,694,1420,70404,26734,97138,M. Rémy NODIN,DIV,2197,2.26,3.22,Battu
07,02,68290,694,1420,70404,26734,97138,M. Gérard MONTREYNAUD,REC,777,0.8,1.14,Battu
07,02,68290,694,1420,70404,26734,97138,M. Jacky RITZ,DSV,613,0.63,0.9,Battu
07,02,68290,694,1420,70404,26734,97138,Mme Michèle GAILLARD,EXG,609,0.63,0.89,Battu
07,02,68290,694,1420,70404,26734,97138,M. Gérard JULIEN,DIV,213,0.22,0.31,Battu
07,03,57371,471,845,58687,22335,81022,M. Cyrille GRANGIER,RN,18328,22.62,31.95,Qualif
07,03,57371,471,845,58687,22335,81022,Mme Florence PALLOT,UG,16239,20.04,28.31,Qualif
07,03,57371,471,845,58687,22335,81022,M. Fabrice BRUN,DVD,15194,18.75,26.48,Qualif
07,03,57371,471,845,58687,22335,81022,M. Quentin BONNETAIN,ENS,5984,7.39,10.43,Battu
07,03,57371,471,845,58687,22335,81022,M. Christophe MARCHISIO,EXG,482,0.59,0.84,Battu
07,03,57371,471,845,58687,22335,81022,M. Jacques MARCESSE,REC,479,0.59,0.83,Battu
07,03,57371,471,845,58687,22335,81022,M. Laurent TOUZET,REG,331,0.41,0.58,Battu
07,03,57371,471,845,58687,22335,81022,M. Alexandre FAURE,EXG,327,0.4,0.57,Battu
07,03,57371,471,845,58687,22335,81022,M. Félix ZAGUEDOUN-REYNAUD,DIV,7,0.01,0.01,Battu
08,01,46480,411,660,47551,23113,70664,M. Flavien TERMET,RN,17817,25.21,38.33,Qualif
08,01,46480,411,660,47551,23113,70664,M. Lionel VUIBERT,ENS,12157,17.2,26.16,Qualif
08,01,46480,411,660,47551,23113,70664,M. Damien LEROUGE,UG,8127,11.5,17.48,Battu
08,01,46480,411,660,47551,23113,70664,M. Christian CHARVET,EXD,4257,6.02,9.16,Battu
08,01,46480,411,660,47551,23113,70664,Mme Sabine MISSET,LR,1782,2.52,3.83,Battu
08,01,46480,411,660,47551,23113,70664,M. Arnaud RENNESSON,DIV,998,1.41,2.15,Battu
08,01,46480,411,660,47551,23113,70664,Mme Sonia D'ORGEVILLE,ECO,956,1.35,2.06,Battu
08,01,46480,411,660,47551,23113,70664,Mme Nadia OCTAVE,EXG,386,0.55,0.83,Battu
08,02,36971,223,375,37569,22712,60281,Mme Pauline MESTER,RN,15097,25.04,40.83,Qualif
08,02,36971,223,375,37569,22712,60281,M. Pierre CORDIER,DVD,11147,18.49,30.15,Qualif
08,02,36971,223,375,37569,22712,60281,M. Gilles LOYEZ,UG,6688,11.09,18.09,Battu
08,02,36971,223,375,37569,22712,60281,M. Philippe MATHOT,ENS,3467,5.75,9.38,Battu
08,02,36971,223,375,37569,22712,60281,Mme Mink TAKAWE,EXG,308,0.51,0.83,Battu
08,02,36971,223,375,37569,22712,60281,M. Patrick BENYOUCEF,EXG,264,0.44,0.71,Battu
08,03,35263,258,349,35870,18614,54484,M. Jean-Luc WARSMANN,DVD,15362,28.2,43.56,Qualif
08,03,35263,258,349,35870,18614,54484,Mme Isabelle ROGER,RN,15296,28.07,43.38,Qualif
08,03,35263,258,349,35870,18614,54484,Mme Sophie PERRIN,UG,4139,7.6,11.74,Battu
08,03,35263,258,349,35870,18614,54484,Mme Laure AUGIER,EXG,466,0.86,1.32,Battu
09,01,37931,969,1930,40830,16586,57416,Mme Martine FROGER,UG,19245,33.52,50.74,Elu
09,01,37931,969,1930,40830,16586,57416,M. Jean-Marc GARNIER,RN,15049,26.21,39.67,Battu
09,01,37931,969,1930,40830,16586,57416,Mme Gisèle LAPEYRE,EXG,2756,4.8,7.27,Battu
09,01,37931,969,1930,40830,16586,57416,M. Pascal MASCETTI,REC,881,1.53,2.32,Battu
09,02,41268,751,1470,43489,18562,62051,M. Laurent PANIFOUS,UG,19911,32.09,48.25,Qualif
09,02,41268,751,1470,43489,18562,62051,Mme Michèle ALOZY,RN,16678,26.88,40.41,Qualif
09,02,41268,751,1470,43489,18562,62051,M. Yann DE KERIMEL,DVD,2023,3.26,4.9,Battu
09,02,41268,751,1470,43489,18562,62051,Mme Théodora TESTARD,EXG,1852,2.98,4.49,Battu
09,02,41268,751,1470,43489,18562,62051,Mme Alexandra TARRIEUX-ANTRANIKIAN,REC,804,1.3,1.95,Battu
10,01,42044,614,836,43494,20479,63973,M. Jordan GUITTON,RN,22636,35.38,53.84,Elu
10,01,42044,614,836,43494,20479,63973,M. Philippe BEURY,ENS,7898,12.35,18.79,Battu
10,01,42044,614,836,43494,20479,63973,Mme Alice BARRY,UG,6019,9.41,14.32,Battu
10,01,42044,614,836,43494,20479,63973,M. Chris MANIERI-BIGORGNE,LR,4921,7.69,11.7,Battu
10,01,42044,614,836,43494,20479,63973,M. Lionel PAILLARD,EXG,570,0.89,1.36,Battu
10,02,49780,451,708,50939,23037,73976,M. Albéric FERRAND,RN,22316,30.17,44.83,Qualif
10,02,49780,451,708,50939,23037,73976,Mme Valérie BAZIN-MALGRAS,LR,13902,18.79,27.93,Qualif
10,02,49780,451,708,50939,23037,73976,Mme Samira SEBBARI,UG,8256,11.16,16.58,Battu
10,02,49780,451,708,50939,23037,73976,Mme Salomé FONTAINE-GARCIA,ENS,4703,6.36,9.45,Battu
10,02,49780,451,708,50939,23037,73976,M. Romain VALLÉE,EXG,603,0.82,1.21,Battu
10,03,41731,309,531,42571,22892,65463,Mme Angélique RANC,RN,18084,27.62,43.33,Qualif
10,03,41731,309,531,42571,22892,65463,M. Olivier GIRARDIN,UG,10178,15.55,24.39,Qualif
10,03,41731,309,531,42571,22892,65463,M. Luc SCHERRER,ENS,6994,10.68,16.76,Battu
10,03,41731,309,531,42571,22892,65463,M. Didier LEPRINCE,LR,3654,5.58,8.76,Battu
10,03,41731,309,531,42571,22892,65463,M. Olivier RICHARD,DVD,1502,2.29,3.6,Battu
10,03,41731,309,531,42571,22892,65463,Mme Nelly COLLOT-TOUZÉ,ECO,970,1.48,2.32,Battu
10,03,41731,309,531,42571,22892,65463,M. Pascal ANDRIEUX,EXG,349,0.53,0.84,Battu
11,01,66724,1038,1706,69468,29751,99219,M. Christophe BARTHÈS,RN,32916,33.18,49.33,Qualif
11,01,66724,1038,1706,69468,29751,99219,M. Philippe POUTOU,UG,12475,12.57,18.7,Qualif
11,01,66724,1038,1706,69468,29751,99219,M. Jean-Claude PEREZ,ENS,11252,11.34,16.86,Battu
11,01,66724,1038,1706,69468,29751,99219,M. Aurélien TURCHETTO,DVG,8463,8.53,12.68,Battu
11,01,66724,1038,1706,69468,29751,99219,M. Fabrice COFFINET,REC,823,0.83,1.23,Battu
11,01,66724,1038,1706,69468,29751,99219,Mme Laure-Nelly AMALRIC,DVC,465,0.47,0.7,Battu
11,01,66724,1038,1706,69468,29751,99219,Mme Nicole GADRAT,EXG,326,0.33,0.49,Battu
11,01,66724,1038,1706,69468,29751,99219,M. Jean-Marc MARIN,LR,4,0,0.01,Battu
11,01,66724,1038,1706,69468,29751,99219,Mme Monique FERRÉ,REG,0,0,0,Battu
11,02,60702,911,1311,62924,29908,92832,M. Frédéric FALCON,RN,29212,31.47,48.12,Qualif
11,02,60702,911,1311,62924,29908,92832,Mme Viviane THIVENT,UG,15795,17.01,26.02,Qualif
11,02,60702,911,1311,62924,29908,92832,Mme Christine BREYTON,ENS,11727,12.63,19.32,Qualif
11,02,60702,911,1311,62924,29908,92832,M. Gérard LENFANT,DIV,1927,2.08,3.17,Battu
11,02,60702,911,1311,62924,29908,92832,M. Alain PEYRE,REC,969,1.04,1.6,Battu
11,02,60702,911,1311,62924,29908,92832,M. Alain BRUN,DVD,654,0.7,1.08,Battu
11,02,60702,911,1311,62924,29908,92832,Mme Annette VIGIER,EXG,418,0.45,0.69,Battu
11,02,60702,911,1311,62924,29908,92832,Mme Nicole GRAU,REG,0,0,0,Battu
11,03,62516,927,1322,64765,25093,89858,M. Julien RANCOULE,RN,27946,31.1,44.7,Qualif
11,03,62516,927,1322,64765,25093,89858,M. Philippe ANDRIEU,UG,20426,22.73,32.67,Qualif
11,03,62516,927,1322,64765,25093,89858,Mme Sylvie SOREL-LESTIN,ENS,8155,9.08,13.04,Battu
11,03,62516,927,1322,64765,25093,89858,M. Jean-François LECLERC,LR,2096,2.33,3.35,Battu
11,03,62516,927,1322,64765,25093,89858,Mme Christine CHAMPION,UDI,1868,2.08,2.99,Battu
11,03,62516,927,1322,64765,25093,89858,M. Bernard BIANCO,DIV,759,0.84,1.21,Battu
11,03,62516,927,1322,64765,25093,89858,Mme Nathalie MARTEEL,REC,681,0.76,1.09,Battu
11,03,62516,927,1322,64765,25093,89858,M. Dominique GALONNIER,EXG,585,0.65,0.94,Battu
12,01,55866,605,1307,57778,20567,78345,M. Stéphane MAZARS,ENS,24349,31.08,43.58,Qualif
12,01,55866,605,1307,57778,20567,78345,M. Jean-Philippe CHARTIER,RN,17586,22.45,31.48,Qualif
12,01,55866,605,1307,57778,20567,78345,M. Léon THEBAULT,UG,12702,16.21,22.74,Qualif
12,01,55866,605,1307,57778,20567,78345,M. Antoine DA CRUZ,DVD,811,1.04,1.45,Battu
12,01,55866,605,1307,57778,20567,78345,Mme Arlette SAINT-AVIT,EXG,418,0.53,0.75,Battu
12,02,48086,781,1399,50266,17951,68217,Mme Marie-Christine PAROLIN,RN,15922,23.34,33.11,Qualif
12,02,48086,781,1399,50266,17951,68217,M. Laurent ALEXANDRE,UG,15738,23.07,32.73,Qualif
12,02,48086,781,1399,50266,17951,68217,M. Samuel DEGUARA,ENS,14690,21.53,30.55,Qualif
12,02,48086,781,1399,50266,17951,68217,M. Jean-Philippe ARMET,DSV,1141,1.67,2.37,Battu
12,02,48086,781,1399,50266,17951,68217,Mme Lucile EL HEDRI,EXG,595,0.87,1.24,Battu
12,03,50891,799,1486,53176,19095,72271,M. Pierre-Antoine FEVRE,UXD,18044,24.97,35.46,Qualif
12,03,50891,799,1486,53176,19095,72271,M. Jean-François ROUSSET,ENS,16514,22.85,32.45,Qualif
12,03,50891,799,1486,53176,19095,72271,M. Richard BOUIGUE,UG,14660,20.28,28.81,Qualif
12,03,50891,799,1486,53176,19095,72271,M. Thierry NOEL,ECO,1066,1.48,2.09,Battu
12,03,50891,799,1486,53176,19095,72271,M. Bernard COMBES,EXG,607,0.84,1.19,Battu
13,01,53312,327,927,54566,28226,82792,Mme Monique GRISETI,RN,24276,29.32,45.54,Qualif
13,01,53312,327,927,54566,28226,82792,Mme Pascaline LÉCORCHÉ,UG,14340,17.32,26.9,Qualif
13,01,53312,327,927,54566,28226,82792,Mme Sabrina AGRESTI-ROUBACHE,ENS,12585,15.2,23.61,Qualif
13,01,53312,327,927,54566,28226,82792,Mme Salomé MOYAL,REC,867,1.05,1.63,Battu
13,01,53312,327,927,54566,28226,82792,Mme Céline CARAVELLAZI,DSV,842,1.02,1.58,Battu
13,01,53312,327,927,54566,28226,82792,M. Marc CECONE,EXG,402,0.49,0.75,Battu
13,02,58752,230,585,59567,24873,84440,M. Olivier RIOULT,RN,18836,22.31,32.06,Qualif
13,02,58752,230,585,59567,24873,84440,M. Laurent LHARDIT,UG,16740,19.82,28.49,Qualif
13,02,58752,230,585,59567,24873,84440,Mme Claire PITOLLAT,ENS,15870,18.79,27.01,Qualif
13,02,58752,230,585,59567,24873,84440,Mme Laure-Agnès CARADEC,LR,5100,6.04,8.68,Battu
13,02,58752,230,585,59567,24873,84440,M. Jean-Marc GRAFFEO,REC,1130,1.34,1.92,Battu
13,02,58752,230,585,59567,24873,84440,M. Hugo ROCHE POGGI,DVG,847,1,1.44,Battu
13,02,58752,230,585,59567,24873,84440,Mme Claudine RODINSON,EXG,229,0.27,0.39,Battu
13,03,46643,331,817,47791,30047,77838,Mme Gisèle LELOUIS,RN,19938,25.61,42.75,Qualif
13,03,46643,331,817,47791,30047,77838,M. Amine KESSACI,UG,16642,21.38,35.68,Qualif
13,03,46643,331,817,47791,30047,77838,Mme Celine AYCARD-DIESTE,ENS,5417,6.96,11.61,Battu
13,03,46643,331,817,47791,30047,77838,M. Pierre-Olivier KOUBI-FLOTTE,LR,2664,3.42,5.71,Battu
13,03,46643,331,817,47791,30047,77838,M. Bernard FOURNIER,REC,937,1.2,2.01,Battu
13,03,46643,331,817,47791,30047,77838,Mme Jacqueline GRANDEL,EXG,402,0.52,0.86,Battu
13,03,46643,331,817,47791,30047,77838,Mme Alexia DE MONTGOLFIER,ECO,381,0.49,0.82,Battu
13,03,46643,331,817,47791,30047,77838,Mme Juliette COLEOU,EXG,262,0.34,0.56,Battu
13,04,39581,308,459,40348,26955,67303,M. Manuel BOMPARD,UG,26712,39.69,67.49,Elu
13,04,39581,308,459,40348,26955,67303,Mme Aurélie QUINQUIS,RN,5973,8.87,15.09,Battu
13,04,39581,308,459,40348,26955,67303,Mme Malika TORCHI,ENS,4370,6.49,11.04,Battu
13,04,39581,308,459,40348,26955,67303,M. Carime IGO,LR,830,1.23,2.1,Battu
13,04,39581,308,459,40348,26955,67303,M. Anthony DEMONT,ECO,723,1.07,1.83,Battu
13,04,39581,308,459,40348,26955,67303,M. Florian TREVISAN,REC,323,0.48,0.82,Battu
13,04,39581,308,459,40348,26955,67303,Mme Isabelle BONNET,EXG,256,0.38,0.65,Battu
13,04,39581,308,459,40348,26955,67303,Mme Leila BEHAIRI,ECO,204,0.3,0.52,Battu
13,04,39581,308,459,40348,26955,67303,M. Stéphane PERNICE,EXG,178,0.26,0.45,Battu
13,04,39581,308,459,40348,26955,67303,M. Kylian Jacky Jean-Luc VISAGE,DIV,11,0.02,0.03,Battu
13,04,39581,308,459,40348,26955,67303,Mme Lea Felice FERRANDI,REG,1,0,0,Battu
13,04,39581,308,459,40348,26955,67303,Mme Eva-Françoise FAYE,DVG,0,0,0,Battu
13,05,50206,297,472,50975,24486,75461,M. Franck LIQUORI,RN,12938,17.15,25.77,Qualif
13,05,50206,297,472,50975,24486,75461,M. Hendrik DAVI,DVG,12271,16.26,24.44,Qualif
13,05,50206,297,472,50975,24486,75461,M. Allan POPELARD,UG,11706,15.51,23.32,Qualif
13,05,50206,297,472,50975,24486,75461,M. Maxime BOUDET,ENS,8985,11.91,17.9,Battu
13,05,50206,297,472,50975,24486,75461,M. Ambroise MALINCONI,LR,2576,3.41,5.13,Battu
13,05,50206,297,472,50975,24486,75461,M. Barthélémy PLEZ,ECO,865,1.15,1.72,Battu
13,05,50206,297,472,50975,24486,75461,M. Marcel BLANC,REC,598,0.79,1.19,Battu
13,05,50206,297,472,50975,24486,75461,Mme Nathalie MALHOLE,EXG,264,0.35,0.53,Battu
13,05,50206,297,472,50975,24486,75461,M. Pierre-Frédéric ZIEBA,DIV,3,0,0.01,Battu
13,05,50206,297,472,50975,24486,75461,Mme Pauline PAPAZIAN,REG,0,0,0,Battu
13,06,50037,278,757,51072,28613,79685,M. Olivier FAYSSAT,UXD,19151,24.03,38.27,Qualif
13,06,50037,278,757,51072,28613,79685,Mme Christine JUSTE,UG,14119,17.72,28.22,Qualif
13,06,50037,278,757,51072,28613,79685,M. Lionel ROYER-PERREAUT,ENS,12575,15.78,25.13,Qualif
13,06,50037,278,757,51072,28613,79685,Mme Serena ZOUAGHI,LR,2231,2.8,4.46,Battu
13,06,50037,278,757,51072,28613,79685,Mme Jeanne ASTOLFI,REC,862,1.08,1.72,Battu
13,06,50037,278,757,51072,28613,79685,Mme Stéphanie BRUN,DVD,348,0.44,0.7,Battu
13,06,50037,278,757,51072,28613,79685,Mme Caroline COURONNE,ECO,276,0.35,0.55,Battu
13,06,50037,278,757,51072,28613,79685,Mme Corinne MOREL,EXG,250,0.31,0.5,Battu
13,06,50037,278,757,51072,28613,79685,M. Sébastien PERETTI,DIV,217,0.27,0.43,Battu
13,06,50037,278,757,51072,28613,79685,M. Alain SLAMA,EXD,4,0.01,0.01,Battu
13,06,50037,278,757,51072,28613,79685,Mme Tess JANNONE,DVC,3,0,0.01,Battu
13,06,50037,278,757,51072,28613,79685,Mme Sylvie GIOVANNINI,REG,1,0,0,Battu
13,07,35402,245,527,36174,32915,69089,M. Sébastien DELOGU,UG,21124,30.58,59.67,Elu
13,07,35402,245,527,36174,32915,69089,M. Arezki SELLOUM,RN,9632,13.94,27.21,Battu
13,07,35402,245,527,36174,32915,69089,Mme Hayat ATIA,ENS,3186,4.61,9,Battu
13,07,35402,245,527,36174,32915,69089,M. Hakim BENAMRANE,DVG,660,0.96,1.86,Battu
13,07,35402,245,527,36174,32915,69089,Mme Ines ALBACETE,REC,481,0.7,1.36,Battu
13,07,35402,245,527,36174,32915,69089,Mme Danièle PÉCOUT,EXG,319,0.46,0.9,Battu
13,08,69434,516,897,70847,32836,103683,M. Romain TONUSSI,RN,30987,29.89,44.63,Qualif
13,08,69434,516,897,70847,32836,103683,M. Jean-Marc ZULESI,ENS,18563,17.9,26.73,Qualif
13,08,69434,516,897,70847,32836,103683,M. Alexandre BEDDOCK,UG,13938,13.44,20.07,Qualif
13,08,69434,516,897,70847,32836,103683,Mme Stéphanie VOLPINI,LR,3105,2.99,4.47,Battu
13,08,69434,516,897,70847,32836,103683,Mme Céline FANFAN,ECO,1882,1.82,2.71,Battu
13,08,69434,516,897,70847,32836,103683,Mme Jeanne VIGIER,REC,617,0.6,0.89,Battu
13,08,69434,516,897,70847,32836,103683,M. Rémy BAZZALI,EXG,342,0.33,0.49,Battu
13,09,66786,438,985,68209,33224,101433,Mme Joëlle MÉLIN,RN,30188,29.76,45.2,Qualif
13,09,66786,438,985,68209,33224,101433,M. Bernard OUGOURLOU-OGLOU,UG,15867,15.64,23.76,Qualif
13,09,66786,438,985,68209,33224,101433,M. Bertrand MAS-FRAISSINET,ENS,12465,12.29,18.66,Battu
13,09,66786,438,985,68209,33224,101433,M. Aurélien MICHEL,LR,5128,5.06,7.68,Battu
13,09,66786,438,985,68209,33224,101433,M. Boualam AKSIL,ECO,1790,1.76,2.68,Battu
13,09,66786,438,985,68209,33224,101433,M. Robert SANTUNIONE,REC,979,0.97,1.47,Battu
13,09,66786,438,985,68209,33224,101433,M. Jean-Marie CLOREC,EXG,319,0.31,0.48,Battu
13,09,66786,438,985,68209,33224,101433,Mme Isabelle MAZZONI,DIV,50,0.05,0.07,Battu
13,10,77149,625,1286,79060,31704,110764,M. José GONZALEZ,RN,37672,34.01,48.83,Qualif
13,10,77149,625,1286,79060,31704,110764,Mme Véronique BOURCET-GINER,ENS,16619,15,21.54,Qualif
13,10,77149,625,1286,79060,31704,110764,M. Jimmy BESSAIH,UG,16050,14.49,20.8,Qualif
13,10,77149,625,1286,79060,31704,110764,M. Stephan PIERRACCINI,LR,2642,2.39,3.42,Battu
13,10,77149,625,1286,79060,31704,110764,Mme Lucie DESBLANCS,ECO,2613,2.36,3.39,Battu
13,10,77149,625,1286,79060,31704,110764,M. Jean-Philippe COURTARO,REC,1031,0.93,1.34,Battu
13,10,77149,625,1286,79060,31704,110764,M. Frédéric KECHRA,EXG,314,0.28,0.41,Battu
13,10,77149,625,1286,79060,31704,110764,M. Hassan TAHIRI,DIV,208,0.19,0.27,Battu
13,11,63095,392,1111,64598,29051,93649,M. Hervé FABRE-AUBRESPY,RN,24524,26.19,38.87,Qualif
13,11,63095,392,1111,64598,29051,93649,M. Marc PENA,UG,17374,18.55,27.54,Qualif
13,11,63095,392,1111,64598,29051,93649,M. Mohamed LAQHILA,ENS,16581,17.71,26.28,Qualif
13,11,63095,392,1111,64598,29051,93649,M. Fayçal ZERGUINE,LR,2562,2.74,4.06,Battu
13,11,63095,392,1111,64598,29051,93649,M. Michel BAYLE,DSV,837,0.89,1.33,Battu
13,11,63095,392,1111,64598,29051,93649,M. Jean François MEBTOUCHE,REC,835,0.89,1.32,Battu
13,11,63095,392,1111,64598,29051,93649,Mme Charlotte MARIA,EXG,382,0.41,0.61,Battu
13,12,61193,330,1296,62819,32546,95365,M. Franck ALLISIO,RN,33086,34.69,54.07,Elu
13,12,61193,330,1296,62819,32546,95365,Mme Maryline CZURKA,UG,14746,15.46,24.1,Battu
13,12,61193,330,1296,62819,32546,95365,M. Axel BRETON,ENS,8508,8.92,13.9,Battu
13,12,61193,330,1296,62819,32546,95365,M. Maxime AGHEMO,LR,3456,3.62,5.65,Battu
13,12,61193,330,1296,62819,32546,95365,Mme Raymonde ZINI,REC,836,0.88,1.37,Battu
13,12,61193,330,1296,62819,32546,95365,M. François ROCHE,EXG,561,0.59,0.92,Battu
13,13,58717,714,1332,60763,34075,94838,M. Emmanuel FOUQUART,RN,27908,29.43,47.53,Qualif
13,13,58717,714,1332,60763,34075,94838,M. Pierre DHARRÉVILLE,UG,21147,22.3,36.02,Qualif
13,13,58717,714,1332,60763,34075,94838,Mme Lila LOKMANE,ENS,7239,7.63,12.33,Battu
13,13,58717,714,1332,60763,34075,94838,M. Hervé DELESPAUL,DSV,934,0.98,1.59,Battu
13,13,58717,714,1332,60763,34075,94838,Mme Olympe SCHEREDRE,REC,876,0.92,1.49,Battu
13,13,58717,714,1332,60763,34075,94838,M. Cyril METRAL,EXG,613,0.65,1.04,Battu
13,14,68670,439,1118,70227,29759,99986,M. Gérault VERNY,UXD,21734,21.74,31.65,Qualif
13,14,68670,439,1118,70227,29759,99986,M. Jean-David CIOT,UG,20242,20.24,29.48,Qualif
13,14,68670,439,1118,70227,29759,99986,Mme Anne-Laurence PETEL,ENS,19853,19.86,28.91,Qualif
13,14,68670,439,1118,70227,29759,99986,M. Gaëtan MUSELET,LR,3869,3.87,5.63,Battu
13,14,68670,439,1118,70227,29759,99986,M. Dominique SASSOON,ECO,1010,1.01,1.47,Battu
13,14,68670,439,1118,70227,29759,99986,M. Charles MOYAL,REC,827,0.83,1.2,Battu
13,14,68670,439,1118,70227,29759,99986,Mme Mireille DUFAY,DSV,635,0.64,0.92,Battu
13,14,68670,439,1118,70227,29759,99986,Mme Anne ROCHE,EXG,470,0.47,0.68,Battu
13,14,68670,439,1118,70227,29759,99986,M. Baptiste BOUCKENHOVE,DVD,30,0.03,0.04,Battu
13,15,75769,634,1726,78129,32577,110706,M. Romain BAUBRY,RN,37493,33.87,49.48,Qualif
13,15,75769,634,1726,78129,32577,110706,Mme Wassila AÏDAROUS,UG,15314,13.83,20.21,Qualif
13,15,75769,634,1726,78129,32577,110706,Mme Solange PONCHON,ENS,12202,11.02,16.1,Battu
13,15,75769,634,1726,78129,32577,110706,M. Stephane HERMELLIN,LR,8272,7.47,10.92,Battu
13,15,75769,634,1726,78129,32577,110706,Mme Martine ELESIKIAN,REC,1414,1.28,1.87,Battu
13,15,75769,634,1726,78129,32577,110706,Mme Anne TESTUT,EXG,617,0.56,0.81,Battu
13,15,75769,634,1726,78129,32577,110706,M. Christophe PTAK,DIV,457,0.41,0.6,Battu
13,16,59805,667,1088,61560,30124,91684,M. Emmanuel TACHE DE LA PAGERIE,RN,28179,30.73,47.12,Qualif
13,16,59805,667,1088,61560,30124,91684,M. Nicolas KOUKAS,UG,17896,19.52,29.92,Qualif
13,16,59805,667,1088,61560,30124,91684,Mme Marion BISCIONE,ENS,8900,9.71,14.88,Battu
13,16,59805,667,1088,61560,30124,91684,M. Alain BERNARDET,LR,3217,3.51,5.38,Battu
13,16,59805,667,1088,61560,30124,91684,M. Florent SEDDIK,REC,712,0.78,1.19,Battu
13,16,59805,667,1088,61560,30124,91684,M. Guy DUBOST,EXG,505,0.55,0.84,Battu
13,16,59805,667,1088,61560,30124,91684,M. Samir BOUZIANI,ECO,396,0.43,0.66,Battu
14,01,52418,397,663,53478,19818,73296,M. Joël BRUNEAU,DVD,22596,30.83,43.11,Qualif
14,01,52418,397,663,53478,19818,73296,Mme Emma FOURREAU,UG,18250,24.9,34.82,Qualif
14,01,52418,397,663,53478,19818,73296,Mme Ludivine DAOUDI,RN,10458,14.27,19.95,Qualif
14,01,52418,397,663,53478,19818,73296,M. Matéo LELOUP,REC,604,0.82,1.15,Battu
14,01,52418,397,663,53478,19818,73296,M. Pierre CASEVITZ,EXG,510,0.7,0.97,Battu
14,02,46436,376,626,47438,21574,69012,M. Arthur DELAPORTE,UG,19662,28.49,42.34,Qualif
14,02,46436,376,626,47438,21574,69012,Mme Josseline LIBAN,RN,11999,17.39,25.84,Qualif
14,02,46436,376,626,47438,21574,69012,Mme Camille BROU,DVD,7159,10.37,15.42,Battu
14,02,46436,376,626,47438,21574,69012,M. Gregory BERKOVICZ,ENS,6503,9.42,14,Battu
14,02,46436,376,626,47438,21574,69012,M. Cédric BAZINCOURT,DSV,566,0.82,1.22,Battu
14,02,46436,376,626,47438,21574,69012,M. Christophe GARCIA,EXG,547,0.79,1.18,Battu
14,03,52502,462,939,53903,26062,79965,M. Edouard FAUVAGE,RN,21575,26.98,41.09,Qualif
14,03,52502,462,939,53903,26062,79965,M. Jérémie PATRIER-LEITUS,ENS,19144,23.94,36.46,Qualif
14,03,52502,462,939,53903,26062,79965,M. Olivier TRUFFAUT,UG,9959,12.45,18.97,Battu
14,03,52502,462,939,53903,26062,79965,M. Steven MAFIODO,DSV,1080,1.35,2.06,Battu
14,03,52502,462,939,53903,26062,79965,M. Michel LANGEVIN,EXG,732,0.92,1.39,Battu
14,03,52502,462,939,53903,26062,79965,M. Thierry Paul VALETTE,DIV,12,0.02,0.02,Battu
14,04,72013,492,1000,73505,31369,104874,Mme Chantal HENRY,RN,24230,23.1,33.65,Qualif
14,04,72013,492,1000,73505,31369,104874,M. Christophe BLANCHET,ENS,23622,22.52,32.8,Qualif
14,04,72013,492,1000,73505,31369,104874,M. Pierre MOURARET,UG,14247,13.58,19.78,Qualif
14,04,72013,492,1000,73505,31369,104874,Mme Sophie GAUGAIN,DVD,7847,7.48,10.9,Battu
14,04,72013,492,1000,73505,31369,104874,Mme Pascale DEUTSCH,REC,878,0.84,1.22,Battu
14,04,72013,492,1000,73505,31369,104874,M. François BUISSON,DSV,747,0.71,1.04,Battu
14,04,72013,492,1000,73505,31369,104874,M. Patrick POIROT-BOURDAIN,EXG,442,0.42,0.61,Battu
14,05,65913,453,952,67318,25628,92946,M. Philippe CHAPRON,RN,21001,22.59,31.86,Qualif
14,05,65913,453,952,67318,25628,92946,M. Bertrand BOUYX,ENS,16208,17.44,24.59,Qualif
14,05,65913,453,952,67318,25628,92946,M. Thomas DUPONT-FEDERICI,UG,16124,17.35,24.46,Qualif
14,05,65913,453,952,67318,25628,92946,M. Cédric NOUVELOT,DVD,10655,11.46,16.17,Battu
14,05,65913,453,952,67318,25628,92946,M. Jean-Alexis GÉREUX,DSV,775,0.83,1.18,Battu
14,05,65913,453,952,67318,25628,92946,M. Tony DESCLOS,REC,662,0.71,1,Battu
14,05,65913,453,952,67318,25628,92946,Mme Isabelle PELTRE,EXG,488,0.53,0.74,Battu
14,06,66402,708,1589,68699,27634,96333,M. Nicolas CALBRIX,RN,24077,24.99,36.26,Qualif
14,06,66402,708,1589,68699,27634,96333,Mme Elisabeth BORNE,ENS,19213,19.94,28.93,Qualif
14,06,66402,708,1589,68699,27634,96333,M. Noé GAUCHARD,UG,15376,15.96,23.16,Qualif
14,06,66402,708,1589,68699,27634,96333,Mme Lynda LAHALLE,DVC,5080,5.27,7.65,Battu
14,06,66402,708,1589,68699,27634,96333,M. Philippe AMBOURG,DSV,1128,1.17,1.7,Battu
14,06,66402,708,1589,68699,27634,96333,Mme Esteline CAILLEMER,REC,650,0.67,0.98,Battu
14,06,66402,708,1589,68699,27634,96333,Mme Pascale GEORGET,EXG,616,0.64,0.93,Battu
14,06,66402,708,1589,68699,27634,96333,Mme Bérengère LAREYNIE,EXG,262,0.27,0.39,Battu
15,01,44114,510,743,45367,16947,62314,M. Vincent DESCOEUR,DVD,16615,26.66,37.66,Qualif
15,01,44114,510,743,45367,16947,62314,Mme Dorothée GALLAIS,RN,13361,21.44,30.29,Qualif
15,01,44114,510,743,45367,16947,62314,Mme Valérie RUEDA,UG,9893,15.88,22.43,Qualif
15,01,44114,510,743,45367,16947,62314,M. Denis SABOT,HOR,3377,5.42,7.66,Battu
15,01,44114,510,743,45367,16947,62314,M. Rémy DAUVILLIER,EXG,458,0.73,1.04,Battu
15,01,44114,510,743,45367,16947,62314,M. Jean-Jacques BRUXELLE,REC,410,0.66,0.93,Battu
15,02,36110,376,592,37078,15232,52310,M. Jean Yves BONY,DVD,12383,23.67,34.29,Qualif
15,02,36110,376,592,37078,15232,52310,M. Gilles LACROIX,RN,11923,22.79,33.02,Qualif
15,02,36110,376,592,37078,15232,52310,Mme Zoé PÉBAY,UG,4919,9.4,13.62,Battu
15,02,36110,376,592,37078,15232,52310,M. Louis TOTY,DVD,3348,6.4,9.27,Battu
15,02,36110,376,592,37078,15232,52310,M. Vladimir TILMANT-TATISCHEFF,ENS,3019,5.77,8.36,Battu
15,02,36110,376,592,37078,15232,52310,Mme Mona CHEIKHI,EXG,298,0.57,0.83,Battu
15,02,36110,376,592,37078,15232,52310,M. Pascal VEYSSET-RAPAPORT,REC,220,0.42,0.61,Battu
16,01,55388,504,1084,56976,27182,84158,M. René PILATO,UG,18166,21.59,32.8,Qualif
16,01,55388,504,1084,56976,27182,84158,M. Thomas MESNIER,HOR,16784,19.94,30.3,Qualif
16,01,55388,504,1084,56976,27182,84158,Mme Marion LATUS,RN,16761,19.92,30.26,Qualif
16,01,55388,504,1084,56976,27182,84158,M. Alain BOIVIN,LR,2226,2.65,4.02,Battu
16,01,55388,504,1084,56976,27182,84158,M. Olivier NICOLAS,EXG,818,0.97,1.48,Battu
16,01,55388,504,1084,56976,27182,84158,Mme Doraline BERNARD,REC,633,0.75,1.14,Battu
16,02,55105,785,1306,57196,26164,83360,M. Barthélemy MARTIN,UXD,21440,25.72,38.91,Qualif
16,02,55105,785,1306,57196,26164,83360,Mme Sandra MARSAUD,ENS,15091,18.1,27.39,Qualif
16,02,55105,785,1306,57196,26164,83360,Mme Carole BALLU,UG,11208,13.45,20.34,Qualif
16,02,55105,785,1306,57196,26164,83360,M. Didier JOBIT,LR,4829,5.79,8.76,Battu
16,02,55105,785,1306,57196,26164,83360,Mme Françoise BESSAS,EXG,832,1,1.51,Battu
16,02,55105,785,1306,57196,26164,83360,M. Alain Gérard JANOT,REC,737,0.88,1.34,Battu
16,02,55105,785,1306,57196,26164,83360,Mme Aurore DE CLISSON,EXD,509,0.61,0.92,Battu
16,02,55105,785,1306,57196,26164,83360,M. Corentin VINSONNEAU,ECO,457,0.55,0.83,Battu
16,03,60484,1119,1456,63059,27607,90666,Mme Caroline COLOMBIER,RN,25976,28.65,42.95,Qualif
16,03,60484,1119,1456,63059,27607,90666,Mme Virginie LEBRAUD,UG,15653,17.26,25.88,Qualif
16,03,60484,1119,1456,63059,27607,90666,M. Gwenhaël FRANÇOIS,ENS,14829,16.36,24.52,Qualif
16,03,60484,1119,1456,63059,27607,90666,M. Dominique SOUCHAUD,UDI,2293,2.53,3.79,Battu
16,03,60484,1119,1456,63059,27607,90666,M. Adrien TOUZÉ,REC,889,0.98,1.47,Battu
16,03,60484,1119,1456,63059,27607,90666,M. Patrick CURGALI,EXG,844,0.93,1.4,Battu
17,01,76297,383,1055,77735,34147,111882,M. Olivier FALORNI,DVG,34824,31.13,45.64,Qualif
17,01,76297,383,1055,77735,34147,111882,M. Jean-Marc SOUBESTE,UG,22618,20.22,29.64,Qualif
17,01,76297,383,1055,77735,34147,111882,Mme Emma CHAUVEAU,RN,17278,15.44,22.65,Qualif
17,01,76297,383,1055,77735,34147,111882,M. Nicolas FRANCOIS,REC,975,0.87,1.28,Battu
17,01,76297,383,1055,77735,34147,111882,M. Antoine COLIN,EXG,430,0.38,0.56,Battu
17,01,76297,383,1055,77735,34147,111882,M. Philippe PERE,DIV,170,0.15,0.22,Battu
17,01,76297,383,1055,77735,34147,111882,Mme Yasmina SAMRI,DVG,2,0,0,Battu
17,01,76297,383,1055,77735,34147,111882,Mme Françoise RAMEL,REG,0,0,0,Battu
17,02,78062,577,1379,80018,33612,113630,Mme Karen BERTHOLOM,RN,26862,23.64,34.41,Qualif
17,02,78062,577,1379,80018,33612,113630,M. Benoît BITEAU,UG,21027,18.5,26.94,Qualif
17,02,78062,577,1379,80018,33612,113630,Mme Anne-Laure BABAULT,ENS,19773,17.4,25.33,Qualif
17,02,78062,577,1379,80018,33612,113630,M. Hervé BLANCHÉ,LR,9651,8.49,12.36,Battu
17,02,78062,577,1379,80018,33612,113630,M. Frédéric CASTELLO,EXG,749,0.66,0.96,Battu
17,03,55715,690,1304,57709,26017,83726,M. Stéphane MORIN,RN,22759,27.18,40.85,Qualif
17,03,55715,690,1304,57709,26017,83726,M. Fabrice BARUSSEAU,UG,15637,18.68,28.07,Qualif
17,03,55715,690,1304,57709,26017,83726,M. Jean-Philippe ARDOUIN,ENS,15536,18.56,27.88,Qualif
17,03,55715,690,1304,57709,26017,83726,Mme Anne-Catherine GODDE,EXG,1196,1.43,2.15,Battu
17,03,55715,690,1304,57709,26017,83726,M. Gérald DAHAN-BERTHELOT,DVG,587,0.7,1.05,Battu
17,04,63065,610,1370,65045,29499,94544,M. Pascal MARKOWSKY,RN,28510,30.16,45.21,Qualif
17,04,63065,610,1370,65045,29499,94544,M. Raphaël GERARD,ENS,17625,18.64,27.95,Qualif
17,04,63065,610,1370,65045,29499,94544,Mme Danièle DESSELLES,UG,10972,11.61,17.4,Battu
17,04,63065,610,1370,65045,29499,94544,Mme Céline DROUILLARD,LR,5251,5.55,8.33,Battu
17,04,63065,610,1370,65045,29499,94544,M. Olivier TRIPELON,EXG,707,0.75,1.12,Battu
17,05,82815,676,1609,85100,35196,120296,M. Aymeric MONGELOUS,RN,36296,30.17,43.83,Qualif
17,05,82815,676,1609,85100,35196,120296,M. Christophe PLASSARD,HOR,27124,22.55,32.75,Qualif
17,05,82815,676,1609,85100,35196,120296,Mme Anne BRACHET,UG,18344,15.25,22.15,Qualif
17,05,82815,676,1609,85100,35196,120296,Mme Danièle CASSETTE,EXG,1051,0.87,1.27,Battu
18,01,45322,306,1326,46954,23447,70401,M. Ugo IANNUZZI,RN,18100,25.71,39.94,Qualif
18,01,45322,306,1326,46954,23447,70401,M. François CORMIER-BOULIGEON,ENS,14961,21.25,33.01,Qualif
18,01,45322,306,1326,46954,23447,70401,M. Hugo LEFELLE,UG,11432,16.24,25.22,Qualif
18,01,45322,306,1326,46954,23447,70401,Mme Sylvie CERVEAU,EXG,680,0.97,1.5,Battu
18,01,45322,306,1326,46954,23447,70401,Mme Sandrine BELLON,REG,149,0.21,0.33,Battu
18,02,42517,530,949,43996,24480,68476,M. Bastian DUENAS,RN,17246,25.19,40.56,Qualif
18,02,42517,530,949,43996,24480,68476,M. Nicolas SANSU,UG,12621,18.43,29.68,Qualif
18,02,42517,530,949,43996,24480,68476,M. Gabriel BEHAGHEL,ENS,8857,12.93,20.83,Qualif
18,02,42517,530,949,43996,24480,68476,M. Philippe BULTEAU,DVD,2705,3.95,6.36,Battu
18,02,42517,530,949,43996,24480,68476,M. Régis ROBIN,EXG,580,0.85,1.36,Battu
18,02,42517,530,949,43996,24480,68476,M. Ludovic JAULIN,REC,508,0.74,1.19,Battu
18,03,54461,450,1215,56126,27519,83645,M. Pierre GENTILLET,RN,23501,28.1,43.15,Qualif
18,03,54461,450,1215,56126,27519,83645,M. Loïc KERVRAN,ENS,16991,20.31,31.2,Qualif
18,03,54461,450,1215,56126,27519,83645,Mme Emma MOREIRA,UG,9334,11.16,17.14,Battu
18,03,54461,450,1215,56126,27519,83645,Mme Bénédicte DE CHOULOT,LR,3178,3.8,5.84,Battu
18,03,54461,450,1215,56126,27519,83645,M. Eric LOUGNON,REC,599,0.72,1.1,Battu
18,03,54461,450,1215,56126,27519,83645,M. Eric BELLET,EXG,568,0.68,1.04,Battu
18,03,54461,450,1215,56126,27519,83645,Mme Christa CHARTIER,DSV,290,0.35,0.53,Battu
19,01,65699,1243,1563,68505,23227,91732,M. François HOLLANDE,UG,24720,26.95,37.63,Qualif
19,01,65699,1243,1563,68505,23227,91732,Mme Maïtey POUGET,RN,20297,22.13,30.89,Qualif
19,01,65699,1243,1563,68505,23227,91732,M. Francis DUBOIS,LR,18816,20.51,28.64,Qualif
19,01,65699,1243,1563,68505,23227,91732,Mme Marie-Thérèse COINAUD,EXG,1303,1.42,1.98,Battu
19,01,65699,1243,1563,68505,23227,91732,M. Gilles OGUINENA,REC,563,0.61,0.86,Battu
19,02,64078,1205,1488,66771,26494,93265,M. Valéry ELOPHE,RN,23250,24.93,36.28,Qualif
19,02,64078,1205,1488,66771,26494,93265,Mme Frédérique MEUNIER,LR,22456,24.08,35.04,Qualif
19,02,64078,1205,1488,66771,26494,93265,Mme Amandine DEWAELE,UG,17063,18.3,26.63,Qualif
19,02,64078,1205,1488,66771,26494,93265,Mme Sylvie SICARD,EXG,1309,1.4,2.04,Battu
21,01,50333,255,657,51245,19250,70495,Mme Océane GODARD,UG,14679,20.82,29.16,Qualif
21,01,50333,255,657,51245,19250,70495,M. Didier MARTIN,ENS,13830,19.62,27.48,Qualif
21,01,50333,255,657,51245,19250,70495,Mme Cyline HUMBLOT-CORNILLE,RN,12969,18.4,25.77,Qualif
21,01,50333,255,657,51245,19250,70495,M. François-Xavier DUGOURD,LR,6126,8.69,12.17,Battu
21,01,50333,255,657,51245,19250,70495,Mme Sladana ZIVKOVIC,DVG,2232,3.17,4.43,Battu
21,01,50333,255,657,51245,19250,70495,M. Julien THÉVENIN,EXG,497,0.71,0.99,Battu
21,02,49598,248,767,50613,21398,72011,Mme Tatiana GUYENOT,RN,17181,23.86,34.64,Qualif
21,02,49598,248,767,50613,21398,72011,Mme Catherine HERVIEU,UG,13723,19.06,27.67,Qualif
21,02,49598,248,767,50613,21398,72011,M. Benoît BORDAT,ENS,12225,16.98,24.65,Qualif
21,02,49598,248,767,50613,21398,72011,M. Laurent BOURGUIGNAT,LR,3982,5.53,8.03,Battu
21,02,49598,248,767,50613,21398,72011,M. Julien GONZALEZ,ECO,1222,1.7,2.46,Battu
21,02,49598,248,767,50613,21398,72011,Mme Claire ROCHER,EXG,522,0.72,1.05,Battu
21,02,49598,248,767,50613,21398,72011,M. Franck GAILLARD,REC,512,0.71,1.03,Battu
21,02,49598,248,767,50613,21398,72011,Mme Elisabeth BERTRAND,DSV,231,0.32,0.47,Battu
21,03,49115,319,927,50361,22065,72426,M. Thierry COUDERT,UXD,17406,24.03,35.44,Qualif
21,03,49115,319,927,50361,22065,72426,M. Pierre PRIBETICH,UG,14533,20.07,29.59,Qualif
21,03,49115,319,927,50361,22065,72426,Mme Fadila KHATTABI,ENS,11695,16.15,23.81,Qualif
21,03,49115,319,927,50361,22065,72426,M. Charle BOURGADEL,LR,3611,4.99,7.35,Battu
21,03,49115,319,927,50361,22065,72426,M. Georges MEZUI,DVG,1176,1.62,2.39,Battu
21,03,49115,319,927,50361,22065,72426,Mme Fabienne DELORME,EXG,694,0.96,1.41,Battu
21,04,46970,374,1083,48427,19020,67447,Mme Sophie DUMONT,RN,19838,29.41,42.24,Qualif
21,04,46970,374,1083,48427,19020,67447,M. Hubert BRIGAND,LR,16531,24.51,35.19,Qualif
21,04,46970,374,1083,48427,19020,67447,Mme Valérie JACQ,UG,9616,14.26,20.47,Qualif
21,04,46970,374,1083,48427,19020,67447,M. Michel DENIZOT,EXG,985,1.46,2.1,Battu
21,05,58529,540,1464,60533,25043,85576,M. René LIORET,RN,26518,30.99,45.31,Qualif
21,05,58529,540,1464,60533,25043,85576,M. Didier PARIS,ENS,18130,21.19,30.98,Qualif
21,05,58529,540,1464,60533,25043,85576,M. Jérôme FLACHE,UG,11297,13.2,19.3,Qualif
21,05,58529,540,1464,60533,25043,85576,M. Arnaud CHERONT,DVD,1532,1.79,2.62,Battu
21,05,58529,540,1464,60533,25043,85576,Mme Françoise PETET,EXG,819,0.96,1.4,Battu
21,05,58529,540,1464,60533,25043,85576,M. Nicolas BAUDOT,DVC,233,0.27,0.4,Battu
22,01,65580,535,1142,67257,23382,90639,M. Mickaël COSSON,ENS,21614,23.85,32.96,Qualif
22,01,65580,535,1142,67257,23382,90639,Mme Marion GORGIARD,UG,19926,21.98,30.38,Qualif
22,01,65580,535,1142,67257,23382,90639,Mme Françoise BILLAUD,RN,16888,18.63,25.75,Qualif
22,01,65580,535,1142,67257,23382,90639,M. Bernard CROGUENNEC,LR,3635,4.01,5.54,Battu
22,01,65580,535,1142,67257,23382,90639,Mme Aourell DANJOU,ECO,1806,1.99,2.75,Battu
22,01,65580,535,1142,67257,23382,90639,M. Alain LE FOL,EXG,671,0.74,1.02,Battu
22,01,65580,535,1142,67257,23382,90639,Mme Virginie MATTASOGLIO,DVC,552,0.61,0.84,Battu
22,01,65580,535,1142,67257,23382,90639,M. Hervé DENIS,EXG,488,0.54,0.74,Battu
22,02,76563,676,958,78197,26320,104517,M. Hervé BERVILLE,ENS,25730,24.62,33.61,Qualif
22,02,76563,676,958,78197,26320,104517,M. Antoine KIEFFER,RN,23707,22.68,30.96,Qualif
22,02,76563,676,958,78197,26320,104517,M. Jérémy DAUPHIN,UG,19685,18.83,25.71,Qualif
22,02,76563,676,958,78197,26320,104517,M. Michel DESBOIS,DVD,5946,5.69,7.77,Battu
22,02,76563,676,958,78197,26320,104517,M. Logan MAHEU,REG,859,0.82,1.12,Battu
22,02,76563,676,958,78197,26320,104517,Mme Lucie HERBLIN,EXG,636,0.61,0.83,Battu
22,03,64211,581,795,65587,23834,89421,M. Corentin LE FUR,LR,20520,22.95,31.96,Qualif
22,03,64211,581,795,65587,23834,89421,Mme Odile DE MELLON,RN,18345,20.52,28.57,Qualif
22,03,64211,581,795,65587,23834,89421,M. Antoine RAVARD,UG,14717,16.46,22.92,Qualif
22,03,64211,581,795,65587,23834,89421,M. Lucas CLEMENT,ENS,9127,10.21,14.21,Battu
22,03,64211,581,795,65587,23834,89421,M. Jean-Pierre LAMOUR,EXG,451,0.5,0.7,Battu
22,03,64211,581,795,65587,23834,89421,M. Bryan TYLI,REG,447,0.5,0.7,Battu
22,03,64211,581,795,65587,23834,89421,Mme Gabrielle GATIEN,DIV,426,0.48,0.66,Battu
22,03,64211,581,795,65587,23834,89421,M. Emmanuel ROUXEL,REG,178,0.2,0.28,Battu
22,04,57440,757,1441,59638,21928,81566,M. Noël LUDE,RN,19700,24.15,34.3,Qualif
22,04,57440,757,1441,59638,21928,81566,Mme Murielle LEPVRAUD,UG,17826,21.85,31.03,Qualif
22,04,57440,757,1441,59638,21928,81566,M. Cyril JOBIC,ENS,17555,21.52,30.56,Qualif
22,04,57440,757,1441,59638,21928,81566,Mme Sylvie LIRONCOURT,EXG,1505,1.85,2.62,Battu
22,04,57440,757,1441,59638,21928,81566,Mme Danielle LE MEN,REC,854,1.05,1.49,Battu
22,05,77958,971,1784,80713,27048,107761,M. Eric BOTHOREL,ENS,29479,27.36,37.81,Qualif
22,05,77958,971,1784,80713,27048,107761,Mme Marielle LEMAITRE,UG,23858,22.14,30.6,Qualif
22,05,77958,971,1784,80713,27048,107761,M. Jean-Yves LE BOULANGER,RN,22668,21.04,29.08,Qualif
22,05,77958,971,1784,80713,27048,107761,M. Yann GUÉGUEN,EXG,1953,1.81,2.51,Battu
23,01,61182,907,1468,63557,26423,89980,M. Bartolomé LENOIR,UXD,20403,22.68,33.35,Qualif
23,01,61182,907,1468,63557,26423,89980,Mme Catherine COUTURIER,UG,14359,15.96,23.47,Qualif
23,01,61182,907,1468,63557,26423,89980,Mme Valérie SIMONET,DVD,13536,15.04,22.12,Qualif
23,01,61182,907,1468,63557,26423,89980,M. Jean-Baptiste MOREAU,ENS,10670,11.86,17.44,Battu
23,01,61182,907,1468,63557,26423,89980,Mme Catherine DUMON,EXG,958,1.06,1.57,Battu
23,01,61182,907,1468,63557,26423,89980,Mme Florence VERHEYEN VALADE,DIV,763,0.85,1.25,Battu
23,01,61182,907,1468,63557,26423,89980,Mme Ana PINSON,REC,493,0.55,0.81,Battu
24,01,52815,922,1245,54982,23125,78107,Mme Nadine LECHON,RN,20199,25.86,38.24,Qualif
24,01,52815,922,1245,54982,23125,78107,Mme Pascale MARTIN,UG,15540,19.9,29.42,Qualif
24,01,52815,922,1245,54982,23125,78107,M. Clément TONON,ENS,12835,16.43,24.3,Qualif
24,01,52815,922,1245,54982,23125,78107,M. Bérenger DESPORT NAMUR,LR,2789,3.57,5.28,Battu
24,01,52815,922,1245,54982,23125,78107,M. Jonathan ALMOSNINO,EXG,751,0.96,1.42,Battu
24,01,52815,922,1245,54982,23125,78107,M. Antoine COUTOU,REC,572,0.73,1.08,Battu
24,01,52815,922,1245,54982,23125,78107,M. Stéphane LAMBERT,DIV,129,0.17,0.24,Battu
24,02,57068,857,1134,59059,25227,84286,M. Serge MULLER,RN,24374,28.92,42.71,Qualif
24,02,57068,857,1134,59059,25227,84286,M. Christophe CATHUS,UG,16131,19.14,28.27,Qualif
24,02,57068,857,1134,59059,25227,84286,M. Michel DELPON,ENS,11173,13.26,19.58,Qualif
24,02,57068,857,1134,59059,25227,84286,Mme Josie BAYLE,LR,4574,5.43,8.01,Battu
24,02,57068,857,1134,59059,25227,84286,Mme Lise KHELFAOUI,EXG,816,0.97,1.43,Battu
24,03,47581,898,995,49474,17473,66947,Mme Florence JOUBERT,RN,19093,28.52,40.13,Qualif
24,03,47581,898,995,49474,17473,66947,Mme Christelle DRUILLOLE,UG,13600,20.31,28.58,Qualif
24,03,47581,898,995,49474,17473,66947,M. Jean-Pierre CUBERTAFON,ENS,11103,16.58,23.33,Qualif
24,03,47581,898,995,49474,17473,66947,Mme Myriam THOMASSON,LR,3104,4.64,6.52,Battu
24,03,47581,898,995,49474,17473,66947,M. Jacques DECOUPY,EXG,681,1.02,1.43,Battu
24,04,63216,1071,1483,65770,24171,89941,Mme Dominique-Louise MARCHAUDON,RN,22767,25.31,36.01,Qualif
24,04,63216,1071,1483,65770,24171,89941,M. Sébastien PEYTAVIE,UG,21801,24.24,34.49,Qualif
24,04,63216,1071,1483,65770,24171,89941,M. Jérôme PEYRAT,DVC,10521,11.7,16.64,Battu
24,04,63216,1071,1483,65770,24171,89941,Mme Anne-Catherine BALLAND,LR,4836,5.38,7.65,Battu
24,04,63216,1071,1483,65770,24171,89941,M. François TOURNE,ENS,1904,2.12,3.01,Battu
24,04,63216,1071,1483,65770,24171,89941,Mme Nathalie BALLERAND,REC,730,0.81,1.15,Battu
24,04,63216,1071,1483,65770,24171,89941,M. Christophe GREEN-MADEO,EXG,657,0.73,1.04,Battu
25,01,52132,414,1096,53642,22151,75793,M. Laurent CROIZIER,ENS,17475,23.06,33.52,Qualif
25,01,52132,414,1096,53642,22151,75793,Mme Séverine VEZIES,UG,16555,21.84,31.76,Qualif
25,01,52132,414,1096,53642,22151,75793,M. Thomas LUTZ,RN,16264,21.46,31.2,Qualif
25,01,52132,414,1096,53642,22151,75793,Mme Marielle PERNIN,ECO,923,1.22,1.77,Battu
25,01,52132,414,1096,53642,22151,75793,Mme Nicole FRIESS,EXG,780,1.03,1.5,Battu
25,01,52132,414,1096,53642,22151,75793,M. Alain RUCH,EXG,133,0.18,0.26,Battu
25,01,52132,414,1096,53642,22151,75793,Mme Elisa MORÉ,REG,2,0,0,Battu
25,02,56084,408,858,57350,21525,78875,Mme Dominique VOYNET,UG,19160,24.29,34.16,Qualif
25,02,56084,408,858,57350,21525,78875,M. Eric FUSIS,RN,16895,21.42,30.12,Qualif
25,02,56084,408,858,57350,21525,78875,M. Benoît VUILLEMIN,ENS,15026,19.05,26.79,Qualif
25,02,56084,408,858,57350,21525,78875,M. Daniel ROY,LR,4215,5.34,7.52,Battu
25,02,56084,408,858,57350,21525,78875,Mme Brigitte VUITTON,EXG,788,1,1.41,Battu
25,03,42381,692,1149,44222,20526,64748,M. Matthieu BLOCH,UXD,18795,29.03,44.35,Qualif
25,03,42381,692,1149,44222,20526,64748,M. Nicolas PACQUOT,ENS,12806,19.78,30.22,Qualif
25,03,42381,692,1149,44222,20526,64748,Mme Virginie DAYET,UG,9138,14.11,21.56,Qualif
25,03,42381,692,1149,44222,20526,64748,M. Brandon KEMPS,DSV,889,1.37,2.1,Battu
25,03,42381,692,1149,44222,20526,64748,M. Franck PLAIN,EXG,753,1.16,1.78,Battu
25,04,41762,408,770,42940,22529,65469,Mme Géraldine GRANGIER,RN,19891,30.38,47.63,Qualif
25,04,41762,408,770,42940,22529,65469,Mme Magali DUVERNOIS,UG,11804,18.03,28.26,Qualif
25,04,41762,408,770,42940,22529,65469,M. Philippe GAUTIER,ENS,8531,13.03,20.43,Qualif
25,04,41762,408,770,42940,22529,65469,M. Yves VOLA,ECO,902,1.38,2.16,Battu
25,04,41762,408,770,42940,22529,65469,M. Michel TREPPO,EXG,634,0.97,1.52,Battu
25,05,57831,591,871,59293,25970,85263,Mme Annie GENEVARD,LR,20356,23.87,35.2,Qualif
25,05,57831,591,871,59293,25970,85263,Mme Florianne JEANDENAND,RN,19505,22.88,33.73,Qualif
25,05,57831,591,871,59293,25970,85263,M. Matthieu CASSEZ,UG,9709,11.39,16.79,Battu
25,05,57831,591,871,59293,25970,85263,M. Lucas BOILLOT,ENS,7176,8.42,12.41,Battu
25,05,57831,591,871,59293,25970,85263,Mme Sonya MORRISON,EXG,588,0.69,1.02,Battu
25,05,57831,591,871,59293,25970,85263,M. Nolann LAURENT,DIV,497,0.58,0.86,Battu
26,01,51947,350,751,53048,24587,77635,M. Paul CHRISTOPHLE,UG,16835,21.68,32.41,Qualif
26,01,51947,350,751,53048,24587,77635,M. Jean-Paul VALLON,RN,16144,20.79,31.08,Qualif
26,01,51947,350,751,53048,24587,77635,Mme Véronique PUGEAT,LR,9292,11.97,17.89,Battu
26,01,51947,350,751,53048,24587,77635,Mme Mireille CLAPOT,ENS,8635,11.12,16.62,Battu
26,01,51947,350,751,53048,24587,77635,M. Thierry AOUSTET,REC,551,0.71,1.06,Battu
26,01,51947,350,751,53048,24587,77635,Mme Adèle KOPFF,EXG,490,0.63,0.94,Battu
26,02,64200,656,1192,66048,31067,97115,Mme Lisette POLLET,RN,27507,28.32,42.85,Qualif
26,02,64200,656,1192,66048,31067,97115,M. Karim CHKERI,UG,14642,15.08,22.81,Qualif
26,02,64200,656,1192,66048,31067,97115,M. Nicolas MICHEL,ENS,12158,12.52,18.94,Qualif
26,02,64200,656,1192,66048,31067,97115,M. Damien LAGIER,LR,6684,6.88,10.41,Battu
26,02,64200,656,1192,66048,31067,97115,M. Karim OUMEDDOUR,DVD,1795,1.85,2.8,Battu
26,02,64200,656,1192,66048,31067,97115,M. Jean-Marc GAILLARD,REC,710,0.73,1.11,Battu
26,02,64200,656,1192,66048,31067,97115,M. Guy RAT,EXG,704,0.72,1.1,Battu
26,03,80649,803,1566,83018,27829,110847,Mme Marie POCHON,UG,30618,27.62,37.96,Qualif
26,03,80649,803,1566,83018,27829,110847,M. Adhémar AUTRAND,UXD,26019,23.47,32.26,Qualif
26,03,80649,803,1566,83018,27829,110847,M. Lander MARCHIONNI,ENS,15396,13.89,19.09,Qualif
26,03,80649,803,1566,83018,27829,110847,Mme Patricia PICARD,LR,6855,6.18,8.5,Battu
26,03,80649,803,1566,83018,27829,110847,M. Charly CHAMPMARTIN,EXG,908,0.82,1.13,Battu
26,03,80649,803,1566,83018,27829,110847,Mme Frédérique SIMONCINI,REC,853,0.77,1.06,Battu
26,04,69374,539,1024,70937,29765,100702,M. Thibaut MONNIER,RN,26621,26.44,38.37,Qualif
26,04,69374,539,1024,70937,29765,100702,Mme Isabelle PAGANI,UG,18222,18.09,26.27,Qualif
26,04,69374,539,1024,70937,29765,100702,Mme Emmanuelle ANTHOINE,LR,16635,16.52,23.98,Qualif
26,04,69374,539,1024,70937,29765,100702,M. Olivier GAFA,ENS,5762,5.72,8.31,Battu
26,04,69374,539,1024,70937,29765,100702,M. Guy BERMOND,DSV,798,0.79,1.15,Battu
26,04,69374,539,1024,70937,29765,100702,Mme Evelyne REYBERT,REC,702,0.7,1.01,Battu
26,04,69374,539,1024,70937,29765,100702,Mme Monique BERNARD,EXG,634,0.63,0.91,Battu
27,01,55556,488,1205,57249,30142,87391,Mme Christine LOIR,RN,25853,29.58,46.54,Qualif
27,01,55556,488,1205,57249,30142,87391,M. Julien CANIN,ENS,15837,18.12,28.51,Qualif
27,01,55556,488,1205,57249,30142,87391,Mme Christine LE BONTÉ,UG,11991,13.72,21.58,Qualif
27,01,55556,488,1205,57249,30142,87391,Mme Anne DUCAMP,EXG,1009,1.15,1.82,Battu
27,01,55556,488,1205,57249,30142,87391,M. Jacques THALMANN,REC,866,0.99,1.56,Battu
27,02,52634,338,1097,54069,25043,79112,Mme Katiana LEVAVASSEUR,RN,22951,29.01,43.6,Qualif
27,02,52634,338,1097,54069,25043,79112,M. Timour VEYRI,UG,11184,14.14,21.25,Qualif
27,02,52634,338,1097,54069,25043,79112,Mme Isabelle COLLIN,ENS,9225,11.66,17.53,Battu
27,02,52634,338,1097,54069,25043,79112,Mme Stéphanie AUGER,DVD,6202,7.84,11.78,Battu
27,02,52634,338,1097,54069,25043,79112,M. Edouard BAUDE,DVD,1658,2.1,3.15,Battu
27,02,52634,338,1097,54069,25043,79112,Mme Mélanie PEYRAUD,EXG,614,0.78,1.17,Battu
27,02,52634,338,1097,54069,25043,79112,Mme Laurence BRÉLY,REC,558,0.71,1.06,Battu
27,02,52634,338,1097,54069,25043,79112,Mme Laure Anne GODARD,DVC,242,0.31,0.46,Battu
27,03,57308,396,1159,58863,26772,85635,M. Kévin MAUVIEUX,RN,28011,32.71,48.88,Qualif
27,03,57308,396,1159,58863,26772,85635,Mme Marie TAMARELLE VERHAEGHE,ENS,12238,14.29,21.35,Qualif
27,03,57308,396,1159,58863,26772,85635,M. Jean-Christophe TURPIN,UG,9146,10.68,15.96,Battu
27,03,57308,396,1159,58863,26772,85635,M. Thomas ELEXHAUSER,DVC,6259,7.31,10.92,Battu
27,03,57308,396,1159,58863,26772,85635,Mme Marie-Noëlle HUARD,EXG,963,1.12,1.68,Battu
27,03,57308,396,1159,58863,26772,85635,M. Didier DARIC,REC,691,0.81,1.21,Battu
27,04,61695,383,1034,63112,30390,93502,M. Patrice PAUPER,RN,25688,27.47,41.64,Qualif
27,04,61695,383,1034,63112,30390,93502,M. Philippe BRUN,UG,21144,22.61,34.27,Qualif
27,04,61695,383,1034,63112,30390,93502,Mme Anne TERLEZ,ENS,10774,11.52,17.46,Battu
27,04,61695,383,1034,63112,30390,93502,M. Olivier ISTIN,DVC,2861,3.06,4.64,Battu
27,04,61695,383,1034,63112,30390,93502,M. Christophe SOLAL,EXG,693,0.74,1.12,Battu
27,04,61695,383,1034,63112,30390,93502,Mme Stacy BLONDEL,REC,536,0.57,0.87,Battu
27,05,58773,378,1042,60193,29619,89812,M. Timothée HOUSSIN,RN,26601,29.62,45.26,Qualif
27,05,58773,378,1042,60193,29619,89812,M. Frédéric DUCHÉ,ENS,14332,15.96,24.39,Qualif
27,05,58773,378,1042,60193,29619,89812,M. Pierre-Yves JOURDAIN,UG,12506,13.92,21.28,Qualif
27,05,58773,378,1042,60193,29619,89812,M. David DAVERTON,LR,3233,3.6,5.5,Battu
27,05,58773,378,1042,60193,29619,89812,M. Christian MAZURE,DVD,911,1.01,1.55,Battu
27,05,58773,378,1042,60193,29619,89812,Mme Delphine BLITMAN,EXG,671,0.75,1.14,Battu
27,05,58773,378,1042,60193,29619,89812,M. Ludovic BEAUJOUAN,DIV,517,0.58,0.88,Battu
27,05,58773,378,1042,60193,29619,89812,M. Colin PRÉVOTEAU DU CLARY,DVD,2,0,0,Battu
28,01,61131,350,1035,62516,29049,91565,Mme Emma MINOT,RN,20576,22.47,33.66,Qualif
28,01,61131,350,1035,62516,29049,91565,M. Guillaume KASBARIAN,ENS,20105,21.96,32.89,Qualif
28,01,61131,350,1035,62516,29049,91565,M. Jean-François BRIDET,UG,14705,16.06,24.05,Qualif
28,01,61131,350,1035,62516,29049,91565,M. Ladislas VERGNE,LR,4388,4.79,7.18,Battu
28,01,61131,350,1035,62516,29049,91565,M. Pierre-Louis DELAUNEY,REC,698,0.76,1.14,Battu
28,01,61131,350,1035,62516,29049,91565,Mme Marie-José AUBERT,EXG,659,0.72,1.08,Battu
28,02,46723,257,723,47703,27860,75563,M. Olivier DUBOIS,RN,17908,23.7,38.33,Qualif
28,02,46723,257,723,47703,27860,75563,M. Olivier MARLEIX,LR,12109,16.03,25.92,Qualif
28,02,46723,257,723,47703,27860,75563,Mme Nadia FAVERIS,UG,11956,15.82,25.59,Qualif
28,02,46723,257,723,47703,27860,75563,M. Florent MAZY,ENS,3381,4.47,7.24,Battu
28,02,46723,257,723,47703,27860,75563,Mme Béatrice JAFFRENOU,EXG,535,0.71,1.15,Battu
28,02,46723,257,723,47703,27860,75563,Mme Florence ROGÉ,REC,477,0.63,1.02,Battu
28,02,46723,257,723,47703,27860,75563,M. Adrien DENIS,EXG,357,0.47,0.76,Battu
28,03,45223,376,1120,46719,24429,71148,M. Christophe BAY,RN,19178,26.96,42.41,Qualif
28,03,45223,376,1120,46719,24429,71148,M. Harold HUWART,DVC,16439,23.11,36.35,Qualif
28,03,45223,376,1120,46719,24429,71148,M. Rémi MARTIAL,LR,5748,8.08,12.71,Battu
28,03,45223,376,1120,46719,24429,71148,M. Vincent CHEVROLLIER,EXG,3107,4.37,6.87,Battu
28,03,45223,376,1120,46719,24429,71148,M. Eric LAQUA,REC,751,1.06,1.66,Battu
28,04,43698,275,823,44796,22555,67351,M. Roger PECOUT,UXD,18854,27.99,43.15,Qualif
28,04,43698,275,823,44796,22555,67351,M. Philippe VIGIER,ENS,17236,25.59,39.44,Qualif
28,04,43698,275,823,44796,22555,67351,Mme Sylviane BOËNS,UG,6243,9.27,14.29,Battu
28,04,43698,275,823,44796,22555,67351,M. Vincent LHOPITEAU,REC,817,1.21,1.87,Battu
28,04,43698,275,823,44796,22555,67351,Mme Anne-Laure ASSAYAG,EXG,548,0.81,1.25,Battu
29,01,67938,495,1156,69589,22747,92336,Mme Annaïg LE MEUR,ENS,22422,24.28,33,Qualif
29,01,67938,495,1156,69589,22747,92336,M. Grégory LEBERT,UG,22303,24.15,32.83,Qualif
29,01,67938,495,1156,69589,22747,92336,Mme Christel HÉNAFF,RN,16083,17.42,23.67,Qualif
29,01,67938,495,1156,69589,22747,92336,M. Alain LE GRAND,LR,5652,6.12,8.32,Battu
29,01,67938,495,1156,69589,22747,92336,M. Serge HARDY,EXG,858,0.93,1.26,Battu
29,01,67938,495,1156,69589,22747,92336,Mme France HERMAN,REC,620,0.67,0.91,Battu
29,02,53426,56,1075,54557,23609,78166,M. Pierre-Yves CADALEN,UG,18850,24.12,35.28,Qualif
29,02,53426,56,1075,54557,23609,78166,M. Denis KERVELLA,RN,12065,15.44,22.58,Qualif
29,02,53426,56,1075,54557,23609,78166,M. Jean-Charles LARSONNEUR,DVC,9874,12.63,18.48,Qualif
29,02,53426,56,1075,54557,23609,78166,M. Tristan BRÉHIER,ENS,9105,11.65,17.04,Battu
29,02,53426,56,1075,54557,23609,78166,Mme Françoise HOUARD,LR,1444,1.85,2.7,Battu
29,02,53426,56,1075,54557,23609,78166,Mme Geneviève HENRY,ECO,1131,1.45,2.12,Battu
29,02,53426,56,1075,54557,23609,78166,M. Alain ROUSSEAU,REC,373,0.48,0.7,Battu
29,02,53426,56,1075,54557,23609,78166,M. Rémy COLLARD,EXG,357,0.46,0.67,Battu
29,02,53426,56,1075,54557,23609,78166,M. Melvyn HITA,EXG,172,0.22,0.32,Battu
29,02,53426,56,1075,54557,23609,78166,M. Martial KOFFI,EXD,55,0.07,0.1,Battu
29,03,67160,358,1505,69023,24830,93853,M. Didier LE GAC,ENS,26139,27.85,38.92,Qualif
29,03,67160,358,1505,69023,24830,93853,Mme Martine DONVAL,RN,18627,19.85,27.74,Qualif
29,03,67160,358,1505,69023,24830,93853,M. Pierre SMOLARZ,UG,18074,19.26,26.91,Qualif
29,03,67160,358,1505,69023,24830,93853,Mme Hélène FAVE,REG,1808,1.93,2.69,Battu
29,03,67160,358,1505,69023,24830,93853,Mme Marie-Louise THOMAS,DSV,1050,1.12,1.56,Battu
29,03,67160,358,1505,69023,24830,93853,M. Matthieu MULLER,EXG,742,0.79,1.1,Battu
29,03,67160,358,1505,69023,24830,93853,M. Ronan PERROT,REC,427,0.45,0.64,Battu
29,03,67160,358,1505,69023,24830,93853,Mme Annie COLINET,DIV,293,0.31,0.44,Battu
29,04,60680,365,963,62008,22356,84364,Mme Sylvaine VULPIANI,UG,18765,22.24,30.92,Qualif
29,04,60680,365,963,62008,22356,84364,Mme Sandrine LE FEUR,ENS,18586,22.03,30.63,Qualif
29,04,60680,365,963,62008,22356,84364,M. Tony BIHOUEE,RN,15690,18.6,25.86,Qualif
29,04,60680,365,963,62008,22356,84364,Mme Agnès LE BRUN,DVD,6697,7.94,11.04,Battu
29,04,60680,365,963,62008,22356,84364,Mme Patricia BLOSSE,EXG,942,1.12,1.55,Battu
29,05,71168,437,1119,72724,26027,98751,Mme Graziella MELCHIOR,ENS,21567,21.84,30.3,Qualif
29,05,71168,437,1119,72724,26027,98751,Mme Gladys GRELAUD,UG,19371,19.62,27.22,Qualif
29,05,71168,437,1119,72724,26027,98751,Mme Renée THOMAÏDIS,RN,18884,19.12,26.53,Qualif
29,05,71168,437,1119,72724,26027,98751,M. Félix BRIANT,LR,7943,8.04,11.16,Battu
29,05,71168,437,1119,72724,26027,98751,M. Marcel BERROU,REG,1807,1.83,2.54,Battu
29,05,71168,437,1119,72724,26027,98751,M. Alexandre MARTIN,DSV,641,0.65,0.9,Battu
29,05,71168,437,1119,72724,26027,98751,M. Christian CAJEAN,EXG,553,0.56,0.78,Battu
29,05,71168,437,1119,72724,26027,98751,M. Dominique LERESTIF,DVC,402,0.41,0.56,Battu
29,06,65116,521,1294,66931,24649,91580,Mme Mélanie THOMIN,UG,24664,26.93,37.88,Qualif
29,06,65116,521,1294,66931,24649,91580,M. Patrick LE FUR,RN,19671,21.48,30.21,Qualif
29,06,65116,521,1294,66931,24649,91580,M. Erwan CROUAN,ENS,18223,19.9,27.99,Qualif
29,06,65116,521,1294,66931,24649,91580,M. Tugdal PERENNEC,DVG,808,0.88,1.24,Battu
29,06,65116,521,1294,66931,24649,91580,M. Philippe CORDIER,EXG,753,0.82,1.16,Battu
29,06,65116,521,1294,66931,24649,91580,Mme Evelyne CARAYON,REC,637,0.7,0.98,Battu
29,06,65116,521,1294,66931,24649,91580,M. Kenny DELFERRIERE,EXG,360,0.39,0.55,Battu
29,07,61026,521,1032,62579,21122,83701,Mme Jugdeep HARVINDER,UG,18952,22.64,31.06,Qualif
29,07,61026,521,1032,62579,21122,83701,Mme Liliana TANGUY,ENS,18709,22.35,30.66,Qualif
29,07,61026,521,1032,62579,21122,83701,Mme Annick ALANOU,RN,15927,19.03,26.1,Qualif
29,07,61026,521,1032,62579,21122,83701,M. Marc RAHER,LR,4470,5.34,7.32,Battu
29,07,61026,521,1032,62579,21122,83701,Mme Aela MALET,REG,1135,1.36,1.86,Battu
29,07,61026,521,1032,62579,21122,83701,M. Régis DEBLIQUI,EXG,972,1.16,1.59,Battu
29,07,61026,521,1032,62579,21122,83701,M. Jacques TANGUY,DVC,861,1.03,1.41,Battu
29,08,64942,542,1139,66623,25116,91739,M. Christian PEREZ,RN,20003,21.8,30.8,Qualif
29,08,64942,542,1139,66623,25116,91739,M. Erwan BALANANT,ENS,18031,19.65,27.76,Qualif
29,08,64942,542,1139,66623,25116,91739,M. Sébastien MIOSSEC,DVG,14399,15.7,22.17,Qualif
29,08,64942,542,1139,66623,25116,91739,M. Thomas LE BON,UG,11768,12.83,18.12,Qualif
29,08,64942,542,1139,66623,25116,91739,Mme Anne MOREL,EXG,741,0.81,1.14,Battu
2A,01,33259,215,365,33839,18651,52490,Mme Ariane QUARENA,RN,10377,19.77,31.2,Qualif
2A,01,33259,215,365,33839,18651,52490,M. Laurent MARCANGELI,ENS,10210,19.45,30.7,Qualif
2A,01,33259,215,365,33839,18651,52490,M. Romain COLONNA,REG,5601,10.67,16.84,Battu
2A,01,33259,215,365,33839,18651,52490,M. Marc-Antoine LEROY,COM,3125,5.95,9.4,Battu
2A,01,33259,215,365,33839,18651,52490,Mme Emmanuelle DOMINICI,REG,1533,2.92,4.61,Battu
2A,01,33259,215,365,33839,18651,52490,M. Lisandru LUCIANI,REG,1202,2.29,3.61,Battu
2A,01,33259,215,365,33839,18651,52490,M. Jean-François LUCIANI,REG,1078,2.05,3.24,Battu
2A,01,33259,215,365,33839,18651,52490,M. Didier QUILICHINI,EXG,133,0.25,0.4,Battu
2A,02,38807,345,469,39621,22874,62495,M. François FILONI,RN,13620,21.79,35.1,Qualif
2A,02,38807,345,469,39621,22874,62495,M. Paul-André COLOMBANI,REG,10266,16.43,26.45,Qualif
2A,02,38807,345,469,39621,22874,62495,Mme Valérie BOZZI,DVD,6538,10.46,16.85,Battu
2A,02,38807,345,469,39621,22874,62495,M. Jean-Baptiste LUCCIONI,SOC,4780,7.65,12.32,Battu
2A,02,38807,345,469,39621,22874,62495,M. Jean-Baptiste CUCCHI,REG,2548,4.08,6.57,Battu
2A,02,38807,345,469,39621,22874,62495,M. Michel CHIOCCA,REG,1055,1.69,2.72,Battu
2B,01,37690,364,499,38553,23561,62114,M. Michel CASTELLANI,REG,11962,19.26,31.74,Qualif
2B,01,37690,364,499,38553,23561,62114,M. Jean-Michel MARCHAL,RN,10855,17.48,28.8,Qualif
2B,01,37690,364,499,38553,23561,62114,M. Julien MORGANTI,DVC,5436,8.75,14.42,Battu
2B,01,37690,364,499,38553,23561,62114,M. Sacha BASTELICA,FI,3352,5.4,8.89,Battu
2B,01,37690,364,499,38553,23561,62114,M. Jean-François PAOLI,DVC,2045,3.29,5.43,Battu
2B,01,37690,364,499,38553,23561,62114,M. Nicolas BATTINI,REG,1603,2.58,4.25,Battu
2B,01,37690,364,499,38553,23561,62114,M. Jean-Baptiste LUCCIARDI,REG,1471,2.37,3.9,Battu
2B,01,37690,364,499,38553,23561,62114,M. Alexis FERNANDEZ,DSV,393,0.63,1.04,Battu
2B,01,37690,364,499,38553,23561,62114,M. Jean-Michel LAMBERTI,REC,370,0.6,0.98,Battu
2B,01,37690,364,499,38553,23561,62114,M. Olivier JOSUÉ,EXG,203,0.33,0.54,Battu
2B,02,44348,393,440,45181,22746,67927,M. François-Xavier CECCOLI,DVD,15100,22.23,34.05,Qualif
2B,02,44348,393,440,45181,22746,67927,M. Jean-Félix ACQUAVIVA,REG,12698,18.69,28.63,Qualif
2B,02,44348,393,440,45181,22746,67927,Mme Sylvie JOUART,RN,11275,16.6,25.42,Qualif
2B,02,44348,393,440,45181,22746,67927,Mme Hélène SANCHEZ,VEC,2668,3.93,6.02,Battu
2B,02,44348,393,440,45181,22746,67927,M. Antò CARLI,REG,2277,3.35,5.13,Battu
2B,02,44348,393,440,45181,22746,67927,Mme Viviane RONGIONE,EXG,280,0.41,0.63,Battu
2B,02,44348,393,440,45181,22746,67927,Mme - BARONNE MARIE-LOUISE MARIANI,DIV,50,0.07,0.11,Battu
2B,02,44348,393,440,45181,22746,67927,M. Jean-Antoine GIACOMI,REG,0,0,0,Battu
30,01,56698,364,870,57932,32430,90362,M. Yoann GILLET,RN,24894,27.55,43.91,Qualif
30,01,56698,364,870,57932,32430,90362,M. Charles MENARD,UG,16747,18.53,29.54,Qualif
30,01,56698,364,870,57932,32430,90362,Mme Valérie ROUVERAND,ENS,11394,12.61,20.1,Qualif
30,01,56698,364,870,57932,32430,90362,Mme Loumy BOURGHOL,LR,3076,3.4,5.43,Battu
30,01,56698,364,870,57932,32430,90362,Mme Isabelle LECLERC,EXG,587,0.65,1.04,Battu
30,02,65928,455,974,67357,28962,96319,M. Nicolas MEIZONNET,RN,34427,35.74,52.22,Elu
30,02,65928,455,974,67357,28962,96319,Mme Katy GUYOT,UG,15727,16.33,23.85,Battu
30,02,65928,455,974,67357,28962,96319,Mme Sophie PELLEGRIN PONSOLE,ENS,9300,9.66,14.11,Battu
30,02,65928,455,974,67357,28962,96319,Mme Catherine BOLLE,LR,4155,4.31,6.3,Battu
30,02,65928,455,974,67357,28962,96319,Mme Véronique JULLIAN,UDI,1841,1.91,2.79,Battu
30,02,65928,455,974,67357,28962,96319,M. Stéphane MANSON,EXG,478,0.5,0.73,Battu
30,03,66265,497,1279,68041,27885,95926,Mme Pascale BORDES,RN,31465,32.8,47.48,Qualif
30,03,66265,497,1279,68041,27885,95926,Mme Sabine OROMI,UG,15181,15.83,22.91,Qualif
30,03,66265,497,1279,68041,27885,95926,M. Christian BAUME,ENS,12727,13.27,19.21,Qualif
30,03,66265,497,1279,68041,27885,95926,M. Florent GRAU,LR,5988,6.24,9.04,Battu
30,03,66265,497,1279,68041,27885,95926,M. Valery FOURMI,EXG,640,0.67,0.97,Battu
30,03,66265,497,1279,68041,27885,95926,M. Christophe PREVOST,REG,199,0.21,0.3,Battu
30,03,66265,497,1279,68041,27885,95926,M. Daniel JEAN,DVD,65,0.07,0.1,Battu
30,04,64421,554,1231,66206,28841,95047,M. Pierre MEURIN,RN,31366,33,48.69,Qualif
30,04,64421,554,1231,66206,28841,95047,M. Arnaud BORD,UG,17639,18.56,27.38,Qualif
30,04,64421,554,1231,66206,28841,95047,Mme Nadia EL OKKI,ENS,10538,11.09,16.36,Battu
30,04,64421,554,1231,66206,28841,95047,M. Pierre MARTIN,LR,3930,4.13,6.1,Battu
30,04,64421,554,1231,66206,28841,95047,M. Jérôme GARCIA,EXG,948,1,1.47,Battu
30,05,67305,729,1571,69605,29366,98971,M. Alexandre ALLEGRET-PILOT,UXD,27602,27.89,41.01,Qualif
30,05,67305,729,1571,69605,29366,98971,M. Michel SALA,UG,22228,22.46,33.03,Qualif
30,05,67305,729,1571,69605,29366,98971,Mme Catherine DAUFÈS-ROUX,ENS,10362,10.47,15.4,Battu
30,05,67305,729,1571,69605,29366,98971,Mme Léa BOYER,LR,5399,5.46,8.02,Battu
30,05,67305,729,1571,69605,29366,98971,Mme Agnès OLINET,EXG,961,0.97,1.43,Battu
30,05,67305,729,1571,69605,29366,98971,M. Nordine TRIA,DIV,752,0.76,1.12,Battu
30,05,67305,729,1571,69605,29366,98971,M. Emmanuel ESPANOL,EXD,1,0,0,Battu
30,06,55584,327,796,56707,28866,85573,Mme Sylvie JOSSERAND,RN,23382,27.32,42.07,Qualif
30,06,55584,327,796,56707,28866,85573,M. Nicolas CADÈNE,UG,15992,18.69,28.77,Qualif
30,06,55584,327,796,56707,28866,85573,M. Aurélien COLSON,ENS,11521,13.46,20.73,Qualif
30,06,55584,327,796,56707,28866,85573,M. Clément STEVANT,LR,3202,3.74,5.76,Battu
30,06,55584,327,796,56707,28866,85573,Mme Laura AFFORTIT,REG,1110,1.3,2,Battu
30,06,55584,327,796,56707,28866,85573,Mme Aïcha TERBECHE,EXG,377,0.44,0.68,Battu
31,01,59277,522,1173,60972,24258,85230,M. Hadrien CLOUET,UG,26985,31.66,45.52,Qualif
31,01,59277,522,1173,60972,24258,85230,Mme Elodie HOBET,ENS,16063,18.85,27.1,Qualif
31,01,59277,522,1173,60972,24258,85230,Mme Lola CHAMBELIN,RN,12636,14.83,21.32,Qualif
31,01,59277,522,1173,60972,24258,85230,Mme Evelyne BOUJAT,DVC,1601,1.88,2.7,Battu
31,01,59277,522,1173,60972,24258,85230,M. Jean-Marie TROUILLET,REC,1028,1.21,1.73,Battu
31,01,59277,522,1173,60972,24258,85230,M. Alexis DE BERRANGER,DIV,574,0.67,0.97,Battu
31,01,59277,522,1173,60972,24258,85230,M. Olivier LE PENVEN,EXG,390,0.46,0.66,Battu
31,02,75017,644,1540,77201,29396,106597,Mme Anne STAMBACH-TERRENOIR,UG,30402,28.52,40.53,Qualif
31,02,75017,644,1540,77201,29396,106597,M. Jean-Luc LAGLEIZE,ENS,20934,19.64,27.91,Qualif
31,02,75017,644,1540,77201,29396,106597,M. Frank KHALIFA,RN,19815,18.59,26.41,Qualif
31,02,75017,644,1540,77201,29396,106597,Mme Pauline LORANS,REC,1366,1.28,1.82,Battu
31,02,75017,644,1540,77201,29396,106597,M. Maxime MAYORAL,ECO,1306,1.23,1.74,Battu
31,02,75017,644,1540,77201,29396,106597,M. Arthur NESTIER,ECO,606,0.57,0.81,Battu
31,02,75017,644,1540,77201,29396,106597,Mme Clotilde BARTHÉLÉMY,EXG,588,0.55,0.78,Battu
31,03,60920,328,815,62063,19856,81919,Mme Agathe ROBY,UG,21064,25.71,34.58,Qualif
31,03,60920,328,815,62063,19856,81919,Mme Corinne VIGNON,ENS,20227,24.69,33.2,Qualif
31,03,60920,328,815,62063,19856,81919,Mme Stéphanie ALARCON,RN,13022,15.9,21.38,Qualif
31,03,60920,328,815,62063,19856,81919,M. Clément DELMAS,LR,3307,4.04,5.43,Battu
31,03,60920,328,815,62063,19856,81919,M. Baptiste ROBERT,DVG,828,1.01,1.36,Battu
31,03,60920,328,815,62063,19856,81919,Mme Marie-Pierre BOUCHET,DVC,731,0.89,1.2,Battu
31,03,60920,328,815,62063,19856,81919,M. Philippe SOLERI,REC,683,0.83,1.12,Battu
31,03,60920,328,815,62063,19856,81919,Mme Domitille ALLORANT,ECO,613,0.75,1.01,Battu
31,03,60920,328,815,62063,19856,81919,Mme Malena ADRADA,EXG,254,0.31,0.42,Battu
31,03,60920,328,815,62063,19856,81919,M. Philippe MAURY,DVD,162,0.2,0.27,Battu
31,03,60920,328,815,62063,19856,81919,M. Noël NÉMOUTHÉ,REG,29,0.04,0.05,Battu
31,04,48103,397,650,49150,20810,69960,M. François PIQUEMAL,UG,25681,36.71,53.39,Elu
31,04,48103,397,650,49150,20810,69960,Mme Margaux PECH,ENS,12950,18.51,26.92,Battu
31,04,48103,397,650,49150,20810,69960,Mme Audrey LARREGLE,RN,7531,10.76,15.66,Battu
31,04,48103,397,650,49150,20810,69960,M. Jacme DELMAS,DVC,945,1.35,1.96,Battu
31,04,48103,397,650,49150,20810,69960,M. Arthur COTTREL,REC,734,1.05,1.53,Battu
31,04,48103,397,650,49150,20810,69960,M. Patrick MARCIREAU,EXG,262,0.37,0.54,Battu
31,04,48103,397,650,49150,20810,69960,M. Paul CAZALS,EXG,0,0,0,Battu
31,05,75653,672,1933,78258,30528,108786,M. Julien LEONARDELLI,RN,29897,27.48,39.52,Qualif
31,05,75653,672,1933,78258,30528,108786,M. Jean-François PORTARRIEU,ENS,22267,20.47,29.43,Qualif
31,05,75653,672,1933,78258,30528,108786,Mme Sylvie ESPAGNOLLE,UG,20925,19.24,27.66,Qualif
31,05,75653,672,1933,78258,30528,108786,Mme Dominique PIUSSAN,REC,1443,1.33,1.91,Battu
31,05,75653,672,1933,78258,30528,108786,M. Michel LASERGE,EXG,1000,0.92,1.32,Battu
31,05,75653,672,1933,78258,30528,108786,Mme Sylvie BONNEMAISON,REG,121,0.11,0.16,Battu
31,06,85317,714,1621,87652,29722,117374,M. Arnaud SIMION,UG,29031,24.73,34.03,Qualif
31,06,85317,714,1621,87652,29722,117374,Mme Nadine DEMANGE-FIERLEJ,RN,26379,22.47,30.92,Qualif
31,06,85317,714,1621,87652,29722,117374,Mme Monique IBORRA,ENS,25256,21.52,29.6,Qualif
31,06,85317,714,1621,87652,29722,117374,Mme Sandra LAPORTE,ECO,2773,2.36,3.25,Battu
31,06,85317,714,1621,87652,29722,117374,M. Annaël GÉRARD,REC,1104,0.94,1.29,Battu
31,06,85317,714,1621,87652,29722,117374,Mme Michèle Marie Rose Albertine PUEL,EXG,774,0.66,0.91,Battu
31,07,74408,795,1914,77117,31112,108229,M. Gaëtan INARD,UXD,30042,27.76,40.37,Qualif
31,07,74408,795,1914,77117,31112,108229,M. Christophe BEX,UG,24681,22.8,33.17,Qualif
31,07,74408,795,1914,77117,31112,108229,Mme Elisabeth TOUTUT-PICARD,ENS,18462,17.06,24.81,Qualif
31,07,74408,795,1914,77117,31112,108229,M. Hervé BERGNES,EXG,1223,1.13,1.64,Battu
31,08,58943,711,1320,60974,25122,86096,M. Loïc DELCHARD,RN,23893,27.75,40.54,Qualif
31,08,58943,711,1320,60974,25122,86096,M. Joël AVIRAGNET,UG,21751,25.26,36.9,Qualif
31,08,58943,711,1320,60974,25122,86096,Mme Céline LAURENTIES-BARRERE,ENS,9227,10.72,15.65,Battu
31,08,58943,711,1320,60974,25122,86096,M. Wilfried SERRE,DVD,1805,2.1,3.06,Battu
31,08,58943,711,1320,60974,25122,86096,Mme Lucie VIOLA,DSV,746,0.87,1.27,Battu
31,08,58943,711,1320,60974,25122,86096,M. Alain PERES,REC,728,0.85,1.24,Battu
31,08,58943,711,1320,60974,25122,86096,Mme Martine GUIRAUD,EXG,536,0.62,0.91,Battu
31,08,58943,711,1320,60974,25122,86096,Mme Dominique DARROZÉS,DVC,257,0.3,0.44,Battu
31,09,55694,469,1026,57189,24179,81368,Mme Christine ARRIGHI,UG,26472,32.53,47.53,Qualif
31,09,55694,469,1026,57189,24179,81368,Mme Caroline BEOUT,RN,13865,17.04,24.89,Qualif
31,09,55694,469,1026,57189,24179,81368,M. Florian DELRIEU,ENS,12451,15.3,22.36,Qualif
31,09,55694,469,1026,57189,24179,81368,Mme Camille CLINET,DVC,1202,1.48,2.16,Battu
31,09,55694,469,1026,57189,24179,81368,Mme Christelle FILIPPI,REC,813,1,1.46,Battu
31,09,55694,469,1026,57189,24179,81368,M. Henri MARTIN,EXG,569,0.7,1.02,Battu
31,09,55694,469,1026,57189,24179,81368,Mme Nathanaëlle LOUBET--SRUH,EXG,322,0.4,0.58,Battu
31,10,79014,636,1891,81541,23611,105152,M. Jacques OBERTI,UG,28631,27.23,36.24,Qualif
31,10,79014,636,1891,81541,23611,105152,Mme Caroline FALGAS-COLOMINA,RN,23993,22.82,30.37,Qualif
31,10,79014,636,1891,81541,23611,105152,Mme Dominique FAURE,ENS,22910,21.79,28.99,Qualif
31,10,79014,636,1891,81541,23611,105152,M. Romain GRESLE,REC,1123,1.07,1.42,Battu
31,10,79014,636,1891,81541,23611,105152,Mme Frédérique SOULIER,DVC,728,0.69,0.92,Battu
31,10,79014,636,1891,81541,23611,105152,M. Adrien BOURGEADE,ECO,558,0.53,0.71,Battu
31,10,79014,636,1891,81541,23611,105152,Mme Lucile SOUCHE,EXG,523,0.5,0.66,Battu
31,10,79014,636,1891,81541,23611,105152,M. Gilles CORSO,DIV,389,0.37,0.49,Battu
31,10,79014,636,1891,81541,23611,105152,Mme Arlette BOUZON,DIV,158,0.15,0.2,Battu
31,10,79014,636,1891,81541,23611,105152,M. François UBEDA,LR,1,0,0,Battu
32,01,52009,769,1382,54160,19098,73258,M. Jean-Luc YELMA,RN,18575,25.36,35.71,Qualif
32,01,52009,769,1382,54160,19098,73258,M. Jean-René CAZENEUVE,ENS,16072,21.94,30.9,Qualif
32,01,52009,769,1382,54160,19098,73258,M. Pascal LEVIEUX,UG,14129,19.29,27.17,Qualif
32,01,52009,769,1382,54160,19098,73258,M. Alexis BOUDAUD ANDUAGA,ECO,1375,1.88,2.64,Battu
32,01,52009,769,1382,54160,19098,73258,M. Ludovic LARRÉ,REG,959,1.31,1.84,Battu
32,01,52009,769,1382,54160,19098,73258,Mme Aurore CAZES,REC,587,0.8,1.13,Battu
32,01,52009,769,1382,54160,19098,73258,M. Jean-Louis CHARETON,EXG,296,0.4,0.57,Battu
32,01,52009,769,1382,54160,19098,73258,M. Adrien AYMES,REG,16,0.02,0.03,Battu
32,02,52806,436,1082,54324,19322,73646,M. David TAUPIAC,DVG,24185,32.84,45.8,Qualif
32,02,52806,436,1082,54324,19322,73646,Mme Alice CENDRÉ,RN,18739,25.44,35.49,Qualif
32,02,52806,436,1082,54324,19322,73646,Mme Barbara NETO,LR,7416,10.07,14.04,Battu
32,02,52806,436,1082,54324,19322,73646,M. Jean-Luc DAVEZAC,REG,1293,1.76,2.45,Battu
32,02,52806,436,1082,54324,19322,73646,Mme Martine ARNAUDY,REC,679,0.92,1.29,Battu
32,02,52806,436,1082,54324,19322,73646,Mme Michèle MARTIN,EXG,481,0.65,0.91,Battu
32,02,52806,436,1082,54324,19322,73646,Mme Abla LAZORAT,REG,13,0.02,0.02,Battu
33,01,74553,388,1002,75943,29920,105863,M. Thomas CAZENAVE,ENS,28564,26.98,38.31,Qualif
33,01,74553,388,1002,75943,29920,105863,Mme Céline PAPIN,UG,25517,24.1,34.23,Qualif
33,01,74553,388,1002,75943,29920,105863,M. Bruno PALUTEAU,RN,15654,14.79,21,Qualif
33,01,74553,388,1002,75943,29920,105863,Mme Béatrice POMAREL,DVC,3143,2.97,4.22,Battu
33,01,74553,388,1002,75943,29920,105863,Mme Virginie TOURNAY,REC,1164,1.1,1.56,Battu
33,01,74553,388,1002,75943,29920,105863,Mme Fanny QUANDALLE,EXG,511,0.48,0.69,Battu
33,02,53686,197,529,54412,19734,74146,M. Nicolas THIERRY,UG,26547,35.8,49.45,Qualif
33,02,53686,197,529,54412,19734,74146,Mme Véronique JURAMY,ENS,15610,21.05,29.08,Qualif
33,02,53686,197,529,54412,19734,74146,Mme Flavie FOURNIER,RN,7510,10.13,13.99,Battu
33,02,53686,197,529,54412,19734,74146,Mme Christine ERRERA,LR,3692,4.98,6.88,Battu
33,02,53686,197,529,54412,19734,74146,M. Guy DUPONT,EXG,307,0.41,0.57,Battu
33,02,53686,197,529,54412,19734,74146,M. Yanis IVA,EXD,20,0.03,0.04,Battu
33,02,53686,197,529,54412,19734,74146,M. David PIJOAN,EXG,0,0,0,Battu
33,03,61539,463,1176,63178,28457,91635,M. Loïc PRUD'HOMME,UG,30664,33.46,49.83,Qualif
33,03,61539,463,1176,63178,28457,91635,Mme Ariane ARY,ENS,17080,18.64,27.75,Qualif
33,03,61539,463,1176,63178,28457,91635,Mme Maryvonne BASTERES,RN,12037,13.14,19.56,Qualif
33,03,61539,463,1176,63178,28457,91635,M. Cyrille DOUMENGE,REC,679,0.74,1.1,Battu
33,03,61539,463,1176,63178,28457,91635,M. Jacques GULDNER,EXG,572,0.62,0.93,Battu
33,03,61539,463,1176,63178,28457,91635,Mme Flora SAVINO,DVG,305,0.33,0.5,Battu
33,03,61539,463,1176,63178,28457,91635,M. Nathan MINVIELLE-LARROUSSE,EXG,196,0.21,0.32,Battu
33,03,61539,463,1176,63178,28457,91635,M. Johan GIRAUD-GIRARD,DIV,4,0,0.01,Battu
33,03,61539,463,1176,63178,28457,91635,M. Yacine TOUZANI,DIV,2,0,0,Battu
33,04,63960,532,1081,65573,34194,99767,M. Alain DAVID,UG,27092,27.16,42.36,Qualif
33,04,63960,532,1081,65573,34194,99767,Mme Julie RECHAGNEUX,RN,20702,20.75,32.37,Qualif
33,04,63960,532,1081,65573,34194,99767,M. Fabrice MORETTI,ENS,11045,11.07,17.27,Battu
33,04,63960,532,1081,65573,34194,99767,M. Jérôme LAMBERT,LR,4387,4.4,6.86,Battu
33,04,63960,532,1081,65573,34194,99767,Mme Anne-Isabelle BRIVARY,EXG,734,0.74,1.15,Battu
33,05,83781,618,1641,86040,37023,123063,M. Grégoire DE FOURNAS,RN,35457,28.81,42.32,Qualif
33,05,83781,618,1641,86040,37023,123063,Mme Pascale GOT,UG,26631,21.64,31.79,Qualif
33,05,83781,618,1641,86040,37023,123063,M. Stéphane SENCE,ENS,15576,12.66,18.59,Qualif
33,05,83781,618,1641,86040,37023,123063,M. Benoït SIMIAN,DVC,3041,2.47,3.63,Battu
33,05,83781,618,1641,86040,37023,123063,M. Laurent TOUSSAINT,DVD,2218,1.8,2.65,Battu
33,05,83781,618,1641,86040,37023,123063,M. Thierry FAGEGALTIER,EXG,858,0.7,1.02,Battu
33,06,78210,518,1398,80126,28883,109009,Mme Marie RECALDE,UG,27564,25.29,35.24,Qualif
33,06,78210,518,1398,80126,28883,109009,M. Eric POULLIAT,ENS,25636,23.52,32.78,Qualif
33,06,78210,518,1398,80126,28883,109009,M. Jimmy BOURLIEUX,RN,21174,19.42,27.07,Qualif
33,06,78210,518,1398,80126,28883,109009,M. Joanthan FLORIT,ECO,1387,1.27,1.77,Battu
33,06,78210,518,1398,80126,28883,109009,Mme Nicole DESTOUESSE,REC,929,0.85,1.19,Battu
33,06,78210,518,1398,80126,28883,109009,M. Franck BONHOMME,DVC,847,0.78,1.08,Battu
33,06,78210,518,1398,80126,28883,109009,M. Guillaume PERCHET,EXG,673,0.62,0.86,Battu
33,07,56921,376,832,58129,22563,80692,M. Sébastien SAINT-PASTEUR,UG,21913,27.16,38.5,Qualif
33,07,56921,376,832,58129,22563,80692,Mme Bérangère COUILLARD,ENS,18854,23.37,33.12,Qualif
33,07,56921,376,832,58129,22563,80692,Mme Clémence NAVEYS--DUMAS,RN,12766,15.82,22.43,Qualif
33,07,56921,376,832,58129,22563,80692,M. Ousmane THIAM,ECO,1597,1.98,2.81,Battu
33,07,56921,376,832,58129,22563,80692,Mme Christelle COTTON,DVC,760,0.94,1.34,Battu
33,07,56921,376,832,58129,22563,80692,M. Dominique DE WITTE,REC,589,0.73,1.03,Battu
33,07,56921,376,832,58129,22563,80692,Mme Monique ORATTO,EXG,442,0.55,0.78,Battu
33,08,84776,663,1463,86902,34656,121558,M. Laurent LAMARA,RN,31248,25.71,36.86,Qualif
33,08,84776,663,1463,86902,34656,121558,Mme Sophie PANONACLE,ENS,26881,22.11,31.71,Qualif
33,08,84776,663,1463,86902,34656,121558,Mme Marylène FAURE,UG,15849,13.04,18.7,Qualif
33,08,84776,663,1463,86902,34656,121558,M. Marc MORIN,LR,8673,7.13,10.23,Battu
33,08,84776,663,1463,86902,34656,121558,Mme Marie-Christine CARIES,REC,1090,0.9,1.29,Battu
33,08,84776,663,1463,86902,34656,121558,M. Rémy COSTE,EXG,898,0.74,1.06,Battu
33,08,84776,663,1463,86902,34656,121558,Mme Céline BLUT,DIV,137,0.11,0.16,Battu
33,09,72301,776,1885,74962,28885,103847,M. François-Xavier MARQUES,RN,27868,26.84,38.54,Qualif
33,09,72301,776,1885,74962,28885,103847,Mme Sophie METTE,ENS,21714,20.91,30.03,Qualif
33,09,72301,776,1885,74962,28885,103847,Mme Corinne MARTINEZ,UG,20163,19.42,27.89,Qualif
33,09,72301,776,1885,74962,28885,103847,M. Jean-Philippe DELCAMP,EXG,1368,1.32,1.89,Battu
33,09,72301,776,1885,74962,28885,103847,Mme Sylvie MANTEL,REC,1188,1.14,1.64,Battu
33,10,57167,605,1267,59039,24550,83589,Mme Sandrine CHADOURNE,RN,25037,29.95,43.8,Qualif
33,10,57167,605,1267,59039,24550,83589,M. Florent BOUDIÉ,ENS,17128,20.49,29.96,Qualif
33,10,57167,605,1267,59039,24550,83589,M. Pascal BOURGOIS,UG,13885,16.61,24.29,Qualif
33,10,57167,605,1267,59039,24550,83589,Mme Hélène HALBIN,EXG,1117,1.34,1.95,Battu
33,11,64855,804,1778,67437,32559,99996,Mme Edwige DIAZ,RN,34590,34.59,53.33,Elu
33,11,64855,804,1778,67437,32559,99996,Mme Véronique HAMMERER,ENS,14619,14.62,22.54,Battu
33,11,64855,804,1778,67437,32559,99996,Mme Cécilia FONSECA,UG,14287,14.29,22.03,Battu
33,11,64855,804,1778,67437,32559,99996,Mme Zina AHMIMOU,EXG,1359,1.36,2.1,Battu
33,12,62529,580,1413,64522,24589,89111,M. Rémy BERTHONNEAU,RN,24016,26.95,38.41,Qualif
33,12,62529,580,1413,64522,24589,89111,Mme Mathilde FELD,UG,18042,20.25,28.85,Qualif
33,12,62529,580,1413,64522,24589,89111,M. Pascal LAVERGNE,ENS,17270,19.38,27.62,Qualif
33,12,62529,580,1413,64522,24589,89111,M. Gabriel LANDETE,DVD,2180,2.45,3.49,Battu
33,12,62529,580,1413,64522,24589,89111,M. Richard LAVIN,EXG,1021,1.15,1.63,Battu
34,01,61248,339,1024,62611,28757,91368,M. Josyan OLIVA,UXD,20891,22.86,34.11,Qualif
34,01,61248,339,1024,62611,28757,91368,M. Jean-Louis ROUMEGAS,UG,20851,22.82,34.04,Qualif
34,01,61248,339,1024,62611,28757,91368,Mme Patricia MIRALLES,ENS,13806,15.11,22.54,Qualif
34,01,61248,339,1024,62611,28757,91368,M. Eric CHAVEROCHE,LR,2626,2.87,4.29,Battu
34,01,61248,339,1024,62611,28757,91368,Mme Stéphanie LÉVY,DVD,1479,1.62,2.41,Battu
34,01,61248,339,1024,62611,28757,91368,M. Alexandre ARGUEL,REC,1104,1.21,1.8,Battu
34,01,61248,339,1024,62611,28757,91368,Mme Morgane LACHIVER,EXG,491,0.54,0.8,Battu
34,02,42437,282,547,43266,23960,67226,Mme Nathalie OZIOL,UG,24707,36.75,58.22,Elu
34,02,42437,282,547,43266,23960,67226,M. Robert LE STUM,ENS,7230,10.75,17.04,Battu
34,02,42437,282,547,43266,23960,67226,Mme Flavia MANGANO,RN,7202,10.71,16.97,Battu
34,02,42437,282,547,43266,23960,67226,Mme Sandra HOUÉE,LR,1821,2.71,4.29,Battu
34,02,42437,282,547,43266,23960,67226,Mme Christelle BOYER,UDI,1157,1.72,2.73,Battu
34,02,42437,282,547,43266,23960,67226,M. Didier MICHEL,EXG,301,0.45,0.71,Battu
34,02,42437,282,547,43266,23960,67226,M. Hugo LEBOON,DIV,19,0.03,0.04,Battu
34,03,67755,482,1164,69401,24655,94056,Mme Fanny DOMBRE-COSTE,UG,22968,24.42,33.9,Qualif
34,03,67755,482,1164,69401,24655,94056,Mme Lauriane TROISE,RN,21872,23.25,32.28,Qualif
34,03,67755,482,1164,69401,24655,94056,Mme Laurence CRISTOL,ENS,19714,20.96,29.1,Qualif
34,03,67755,482,1164,69401,24655,94056,M. Flavio DALMAU,ECO,2049,2.18,3.02,Battu
34,03,67755,482,1164,69401,24655,94056,Mme Babeth SEGURA,REC,793,0.84,1.17,Battu
34,03,67755,482,1164,69401,24655,94056,M. Serge GACHON,EXG,359,0.38,0.53,Battu
34,04,85354,804,2111,88269,32147,120416,Mme Manon BOUQUIN,RN,35216,29.25,41.26,Qualif
34,04,85354,804,2111,88269,32147,120416,M. Sébastien ROME,UG,28171,23.39,33,Qualif
34,04,85354,804,2111,88269,32147,120416,M. Jean-François ELIAOU,ENS,19260,15.99,22.56,Qualif
34,04,85354,804,2111,88269,32147,120416,Mme Bleuette SIMON,REC,1822,1.51,2.13,Battu
34,04,85354,804,2111,88269,32147,120416,Mme Florence LARUE,EXG,886,0.74,1.04,Battu
34,05,67066,776,1736,69578,30432,100010,Mme Stéphanie GALZY,RN,32781,32.78,48.88,Qualif
34,05,67066,776,1736,69578,30432,100010,M. Aurélien MANENC,UG,21640,21.64,32.27,Qualif
34,05,67066,776,1736,69578,30432,100010,M. Philippe HUPPÉ,ENS,9369,9.37,13.97,Battu
34,05,67066,776,1736,69578,30432,100010,M. Lilian BOURRIE,REC,1346,1.35,2.01,Battu
34,05,67066,776,1736,69578,30432,100010,M. Rémy GROUSSARD,DIV,1121,1.12,1.67,Battu
34,05,67066,776,1736,69578,30432,100010,Mme Véronique CHESNARD,EXG,809,0.81,1.21,Battu
34,06,62278,363,941,63582,31359,94941,M. Julien GABARRON,RN,25563,26.93,41.05,Qualif
34,06,62278,363,941,63582,31359,94941,Mme Emmanuelle MÉNARD,DVD,16968,17.87,27.25,Qualif
34,06,62278,363,941,63582,31359,94941,Mme Magali CROZIER,UG,13126,13.83,21.08,Qualif
34,06,62278,363,941,63582,31359,94941,Mme Sarah Fatima DAUDÉ-ALLAOUI,ENS,6149,6.48,9.87,Battu
34,06,62278,363,941,63582,31359,94941,M. Laurent GILHODES,EXG,472,0.5,0.76,Battu
34,07,72575,873,1485,74933,35529,110462,M. Aurélien LOPEZ-LIGUORI,RN,37495,33.94,51.66,Elu
34,07,72575,873,1485,74933,35529,110462,M. Gabriel BLASCO,UG,18415,16.67,25.37,Battu
34,07,72575,873,1485,74933,35529,110462,Mme Jocelyne GIZARDIN,ENS,15618,14.14,21.52,Battu
34,07,72575,873,1485,74933,35529,110462,M. Daniel PILAUDEAU,EXG,1047,0.95,1.44,Battu
34,08,64381,571,1112,66064,29580,95644,M. Cédric DELAPIERRE,RN,25831,27.01,40.12,Qualif
34,08,64381,571,1112,66064,29580,95644,M. Sylvain CARRIERE,UG,21061,22.02,32.71,Qualif
34,08,64381,571,1112,66064,29580,95644,Mme Isabelle AUTIER,ENS,10854,11.35,16.86,Battu
34,08,64381,571,1112,66064,29580,95644,Mme Bérangère DUBUS,DVD,4083,4.27,6.34,Battu
34,08,64381,571,1112,66064,29580,95644,Mme Sabria BOUALLAGA,ECO,2019,2.11,3.14,Battu
34,08,64381,571,1112,66064,29580,95644,M. Thomas GARNIER,EXG,533,0.56,0.83,Battu
34,09,59666,581,1124,61371,29271,90642,M. Charles ALLONCLE,UXD,21734,23.98,36.43,Qualif
34,09,59666,581,1124,61371,29271,90642,Mme Nadia BELAOUNI,UG,17463,19.27,29.27,Qualif
34,09,59666,581,1124,61371,29271,90642,M. Patrick VIGNAL,ENS,14918,16.46,25,Qualif
34,09,59666,581,1124,61371,29271,90642,M. Anthony BELIN,DVD,2046,2.26,3.43,Battu
34,09,59666,581,1124,61371,29271,90642,M. Frédéric BORT,REC,1481,1.63,2.48,Battu
34,09,59666,581,1124,61371,29271,90642,M. William VISTE,DVD,899,0.99,1.51,Battu
34,09,59666,581,1124,61371,29271,90642,M. Patrice BOCCADIFUOCO,DVD,584,0.64,0.98,Battu
34,09,59666,581,1124,61371,29271,90642,Mme Nathalie PEIRO,EXG,459,0.51,0.77,Battu
34,09,59666,581,1124,61371,29271,90642,M. Géry LALY,DVD,82,0.09,0.14,Battu
35,01,67287,458,1089,68834,25504,94338,Mme Marie MESMEUR,UG,28467,30.18,42.31,Qualif
35,01,67287,458,1089,68834,25504,94338,M. Nicolas BOUCHER,ENS,21453,22.74,31.88,Qualif
35,01,67287,458,1089,68834,25504,94338,Mme Jeanne REY DU BOISSIEU,RN,11878,12.59,17.65,Qualif
35,01,67287,458,1089,68834,25504,94338,Mme Joëlle LE GALL,LR,3372,3.57,5.01,Battu
35,01,67287,458,1089,68834,25504,94338,M. Sébastien GIRARD,REG,887,0.94,1.32,Battu
35,01,67287,458,1089,68834,25504,94338,Mme Valérie HAMON,EXG,875,0.93,1.3,Battu
35,01,67287,458,1089,68834,25504,94338,Mme Rosa VASQUEZ,DVG,347,0.37,0.52,Battu
35,01,67287,458,1089,68834,25504,94338,M. Frédéric MATHIEU,DVG,8,0.01,0.01,Battu
35,02,75318,450,1022,76790,23110,99900,M. Tristan LAHAIS,UG,30361,30.39,40.31,Qualif
35,02,75318,450,1022,76790,23110,99900,Mme Laurence MAILLART-MÉHAIGNERIE,ENS,25792,25.82,34.24,Qualif
35,02,75318,450,1022,76790,23110,99900,Mme Bérénice VANHAECKE,RN,13130,13.14,17.43,Qualif
35,02,75318,450,1022,76790,23110,99900,M. Christophe DECOURCELLE,LR,5218,5.22,6.93,Battu
35,02,75318,450,1022,76790,23110,99900,Mme Florence DEFRANCE,EXG,746,0.75,0.99,Battu
35,02,75318,450,1022,76790,23110,99900,M. Olivier HANNE,ECO,71,0.07,0.09,Battu
35,03,67040,646,1162,68848,24526,93374,Mme Claudia ROUAUX,UG,24649,26.4,36.77,Qualif
35,03,67040,646,1162,68848,24526,93374,Mme Charlotte FAILLÉ,ENS,19919,21.33,29.71,Qualif
35,03,67040,646,1162,68848,24526,93374,Mme Virginie D'ORSANNE,RN,18850,20.19,28.12,Qualif
35,03,67040,646,1162,68848,24526,93374,M. Victor ROULET,DVD,1688,1.81,2.52,Battu
35,03,67040,646,1162,68848,24526,93374,M. Mathieu GUIHARD,REG,1132,1.21,1.69,Battu
35,03,67040,646,1162,68848,24526,93374,M. Jean-Louis AMISSE,EXG,802,0.86,1.2,Battu
35,04,68965,543,1420,70928,26760,97688,M. Jacques FRANÇOIS,RN,22275,22.8,32.3,Qualif
35,04,68965,543,1420,70928,26760,97688,Mme Mathilde HIGNET,UG,22139,22.66,32.1,Qualif
35,04,68965,543,1420,70928,26760,97688,Mme Anne PATAULT,ENS,16595,16.99,24.06,Qualif
35,04,68965,543,1420,70928,26760,97688,M. Jeremy GILBERT,LR,6103,6.25,8.85,Battu
35,04,68965,543,1420,70928,26760,97688,Mme Sophie HUBERT,DSV,985,1.01,1.43,Battu
35,04,68965,543,1420,70928,26760,97688,Mme Sandra CHIRAZI,EXG,868,0.89,1.26,Battu
35,05,78138,870,1902,80910,30678,111588,Mme Christine LE NABOUR,ENS,33147,29.7,42.42,Qualif
35,05,78138,870,1902,80910,30678,111588,Mme Françoise GILOIS,RN,23298,20.88,29.82,Qualif
35,05,78138,870,1902,80910,30678,111588,M. Gilles RENAULT,UG,20200,18.1,25.85,Qualif
35,05,78138,870,1902,80910,30678,111588,Mme Christelle JARNY,EXG,1493,1.34,1.91,Battu
35,06,64509,536,1141,66186,24462,90648,M. Thierry BENOIT,ENS,26968,29.75,41.81,Qualif
35,06,64509,536,1141,66186,24462,90648,M. Tangi MARION,RN,19960,22.02,30.94,Qualif
35,06,64509,536,1141,66186,24462,90648,Mme Elsa LAFAYE,UG,16209,17.88,25.13,Qualif
35,06,64509,536,1141,66186,24462,90648,M. Ludovic HUBERT,EXG,839,0.93,1.3,Battu
35,06,64509,536,1141,66186,24462,90648,M. Pascal THEVENET,DVC,402,0.44,0.62,Battu
35,06,64509,536,1141,66186,24462,90648,M. Gilliatt DE STAËRCK,DVG,131,0.14,0.2,Battu
35,07,75114,437,1095,76646,30003,106649,M. Jean-Luc BOURGEAUX,DVD,32549,30.52,43.33,Qualif
35,07,75114,437,1095,76646,30003,106649,M. Dylan LEMOINE,RN,21184,19.86,28.2,Qualif
35,07,75114,437,1095,76646,30003,106649,M. Nicolas GUIVARC'H,UG,16701,15.66,22.23,Qualif
35,07,75114,437,1095,76646,30003,106649,M. Christophe FICHET,DVC,3665,3.44,4.88,Battu
35,07,75114,437,1095,76646,30003,106649,M. Edouard DESCOTTES,EXG,1015,0.95,1.35,Battu
35,08,68183,354,717,69254,22703,91957,M. Mickaël BOULOUX,UG,36029,39.18,52.84,Elu
35,08,68183,354,717,69254,22703,91957,Mme Hermine MAUZE,ENS,17517,19.05,25.69,Battu
35,08,68183,354,717,69254,22703,91957,Mme Kellie LUCCO,RN,9820,10.68,14.4,Battu
35,08,68183,354,717,69254,22703,91957,M. Mahé GARGAM,LR,3390,3.69,4.97,Battu
35,08,68183,354,717,69254,22703,91957,M. Maël EGRON,REG,768,0.84,1.13,Battu
35,08,68183,354,717,69254,22703,91957,M. Fabrice LUCAS,EXG,654,0.71,0.96,Battu
35,08,68183,354,717,69254,22703,91957,M. Camille CHAMPALAUNE,ECO,5,0.01,0.01,Battu
36,01,49141,646,1132,50919,26156,77075,Mme Mylène WUNSCH,RN,19755,25.63,40.2,Qualif
36,01,49141,646,1132,50919,26156,77075,M. François JOLIVET,HOR,17256,22.39,35.12,Qualif
36,01,49141,646,1132,50919,26156,77075,Mme Eloïse GONZALEZ,UG,10658,13.83,21.69,Qualif
36,01,49141,646,1132,50919,26156,77075,Mme Véronique GELINAUD,EXG,756,0.98,1.54,Battu
36,01,49141,646,1132,50919,26156,77075,Mme Marie-Odile TRUSCH,REC,716,0.93,1.46,Battu
36,02,58762,814,1400,60976,26395,87371,M. Marc SIFFERT,UXD,24512,28.06,41.71,Qualif
36,02,58762,814,1400,60976,26395,87371,M. Nicolas FORISSIER,LR,18700,21.4,31.82,Qualif
36,02,58762,814,1400,60976,26395,87371,M. Clément SAPIN,UG,13783,15.78,23.46,Qualif
36,02,58762,814,1400,60976,26395,87371,M. Damien MERCIER,EXG,931,1.07,1.58,Battu
36,02,58762,814,1400,60976,26395,87371,M. Pierre SCHWARZ,DIV,836,0.96,1.42,Battu
37,01,46886,254,565,47705,24259,71964,M. Charles FOURNIER,UG,21250,29.53,45.32,Qualif
37,01,46886,254,565,47705,24259,71964,M. Benoist PIERRE,ENS,11333,15.75,24.17,Qualif
37,01,46886,254,565,47705,24259,71964,Mme Lisa GARBAY,RN,8870,12.33,18.92,Battu
37,01,46886,254,565,47705,24259,71964,M. Lucas JANER,LR,2774,3.85,5.92,Battu
37,01,46886,254,565,47705,24259,71964,M. Alain DAYAN,DVG,1690,2.35,3.6,Battu
37,01,46886,254,565,47705,24259,71964,M. Arnaud OSSART,REC,496,0.69,1.06,Battu
37,01,46886,254,565,47705,24259,71964,M. Thomas JOUHANNAUD,EXG,473,0.66,1.01,Battu
37,02,63837,530,1302,65669,27451,93120,Mme Corine FOUGERON,RN,22396,24.05,35.08,Qualif
37,02,63837,530,1302,65669,27451,93120,M. Daniel LABARONNE,ENS,20801,22.34,32.58,Qualif
37,02,63837,530,1302,65669,27451,93120,Mme Christelle GOBERT,UG,14891,15.99,23.33,Qualif
37,02,63837,530,1302,65669,27451,93120,M. Maxime MAINTIER,LR,4123,4.43,6.46,Battu
37,02,63837,530,1302,65669,27451,93120,Mme Anne BRUNET,EXG,938,1.01,1.47,Battu
37,02,63837,530,1302,65669,27451,93120,M. Philippe SAINTIGNAN,REC,688,0.74,1.08,Battu
37,03,67453,729,1633,69815,29596,99411,M. Henri ALFANDARI,ENS,22174,22.31,32.87,Qualif
37,03,67453,729,1633,69815,29596,99411,M. Jules ROBIN,UXD,21724,21.85,32.21,Qualif
37,03,67453,729,1633,69815,29596,99411,Mme Sandra BARBIER,UG,17240,17.34,25.56,Qualif
37,03,67453,729,1633,69815,29596,99411,M. Emmanuel FRANÇOIS,DIV,3248,3.27,4.82,Battu
37,03,67453,729,1633,69815,29596,99411,M. Christophe LEGENDRE,EXG,1060,1.07,1.57,Battu
37,03,67453,729,1633,69815,29596,99411,M. Amin BRIMOU,DIV,1004,1.01,1.49,Battu
37,03,67453,729,1633,69815,29596,99411,M. Xavier BOURIN,REC,1003,1.01,1.49,Battu
37,04,61812,531,1145,63488,29246,92734,M. Jean-François BELLANGER,RN,20328,21.92,32.89,Qualif
37,04,61812,531,1145,63488,29246,92734,M. Laurent BAUMEL,UG,18374,19.81,29.73,Qualif
37,04,61812,531,1145,63488,29246,92734,Mme Fabienne COLBOC,ENS,17092,18.43,27.65,Qualif
37,04,61812,531,1145,63488,29246,92734,Mme Sophie LAGRÉE,LR,5287,5.7,8.55,Battu
37,04,61812,531,1145,63488,29246,92734,M. Kévin GARDEAU,EXG,731,0.79,1.18,Battu
37,05,59914,483,1165,61562,26115,87677,M. François DUCAMP,RN,21118,24.09,35.25,Qualif
37,05,59914,483,1165,61562,26115,87677,Mme Sabine THILLAYE,ENS,16025,18.28,26.75,Qualif
37,05,59914,483,1165,61562,26115,87677,Mme Marina COCCIA,UG,14457,16.49,24.13,Qualif
37,05,59914,483,1165,61562,26115,87677,Mme Constance BALES,LR,6805,7.76,11.36,Battu
37,05,59914,483,1165,61562,26115,87677,M. David BILLON,REC,809,0.92,1.35,Battu
37,05,59914,483,1165,61562,26115,87677,Mme Christine DELARUE,EXG,700,0.8,1.17,Battu
38,01,62720,237,675,63632,20247,83879,M. Hugo PREVOST,UG,25207,30.05,40.19,Qualif
38,01,62720,237,675,63632,20247,83879,M. Olivier VÉRAN,ENS,21089,25.14,33.62,Qualif
38,01,62720,237,675,63632,20247,83879,M. Alexandre LACROIX,UXD,11504,13.71,18.34,Qualif
38,01,62720,237,675,63632,20247,83879,Mme Nathalie BÉRANGER,LR,4379,5.22,6.98,Battu
38,01,62720,237,675,63632,20247,83879,M. Rémi ADAM,EXG,541,0.64,0.86,Battu
38,02,52607,295,898,53800,25415,79215,Mme Cyrielle CHATELAIN,UG,22185,28.01,42.17,Qualif
38,02,52607,295,898,53800,25415,79215,M. Edouard ROBERT,RN,16043,20.25,30.5,Qualif
38,02,52607,295,898,53800,25415,79215,Mme Louve CARRIÈRE,ENS,10114,12.77,19.23,Qualif
38,02,52607,295,898,53800,25415,79215,Mme Raphaele DE CARVALHO,LR,3064,3.87,5.82,Battu
38,02,52607,295,898,53800,25415,79215,Mme Chantal GOMEZ,EXG,661,0.83,1.26,Battu
38,02,52607,295,898,53800,25415,79215,M. Bruno LAFEUILLE,REC,540,0.68,1.03,Battu
38,03,39530,250,446,40226,17232,57458,Mme Élisa MARTIN,UG,16933,29.47,42.84,Qualif
38,03,39530,250,446,40226,17232,57458,Mme Christel DUPRÉ,RN,8989,15.64,22.74,Qualif
38,03,39530,250,446,40226,17232,57458,Mme Émilie CHALAS,ENS,7908,13.76,20.01,Qualif
38,03,39530,250,446,40226,17232,57458,M. Stéphane GEMMANI,DVG,3059,5.32,7.74,Battu
38,03,39530,250,446,40226,17232,57458,Mme Coline GENEVOIS,LR,1103,1.92,2.79,Battu
38,03,39530,250,446,40226,17232,57458,M. M'Hamed BENHAROUGA,UDI,370,0.64,0.94,Battu
38,03,39530,250,446,40226,17232,57458,M. Khemisti BOUBEKER,DVG,289,0.5,0.73,Battu
38,03,39530,250,446,40226,17232,57458,Mme Isabelle FASSION,REC,251,0.44,0.63,Battu
38,03,39530,250,446,40226,17232,57458,Mme Catherine BRUN,EXG,223,0.39,0.56,Battu
38,03,39530,250,446,40226,17232,57458,M. Louiliam CLOT,ECO,181,0.32,0.46,Battu
38,03,39530,250,446,40226,17232,57458,M. Baptiste ANGLADE,EXG,142,0.25,0.36,Battu
38,03,39530,250,446,40226,17232,57458,M. Samuel LE FOURN,EXG,82,0.14,0.21,Battu
38,04,64787,329,1100,66216,26385,92601,Mme Marie-Noëlle BATTISTEL,UG,27548,29.75,42.52,Qualif
38,04,64787,329,1100,66216,26385,92601,Mme Anne-Marie MALANDRINO,UXD,20812,22.47,32.12,Qualif
38,04,64787,329,1100,66216,26385,92601,Mme Evelyne DE CARO,ENS,7751,8.37,11.96,Battu
38,04,64787,329,1100,66216,26385,92601,Mme Alexandra VEYRET,LR,7219,7.8,11.14,Battu
38,04,64787,329,1100,66216,26385,92601,M. David BABUT,REC,838,0.9,1.29,Battu
38,04,64787,329,1100,66216,26385,92601,M. Alain ZIEGLER,EXG,619,0.67,0.96,Battu
38,05,76863,402,1296,78561,28359,106920,M. Jérémie IORDANOFF,UG,27991,26.18,36.42,Qualif
38,05,76863,402,1296,78561,28359,106920,Mme Frédérique SCHREIBER,RN,23674,22.14,30.8,Qualif
38,05,76863,402,1296,78561,28359,106920,M. Jean-Charles COLAS-ROY,ENS,15783,14.76,20.53,Qualif
38,05,76863,402,1296,78561,28359,106920,M. Dominique ESCARON,DVC,7250,6.78,9.43,Battu
38,05,76863,402,1296,78561,28359,106920,M. Philippe GARRIGOS,DSV,791,0.74,1.03,Battu
38,05,76863,402,1296,78561,28359,106920,Mme Christine TULIPE,EXG,755,0.71,0.98,Battu
38,05,76863,402,1296,78561,28359,106920,Mme Béatrice LACROUTS,REC,619,0.58,0.81,Battu
38,06,61335,316,1201,62852,28202,91054,M. Alexis JOLLY,RN,29167,32.03,47.55,Qualif
38,06,61335,316,1201,62852,28202,91054,Mme Yaqine DI SPIGNO,UG,12791,14.05,20.85,Qualif
38,06,61335,316,1201,62852,28202,91054,Mme Cendra MOTIN,ENS,10712,11.76,17.46,Battu
38,06,61335,316,1201,62852,28202,91054,Mme Annie POURTIER,LR,7816,8.58,12.74,Battu
38,06,61335,316,1201,62852,28202,91054,Mme Denise GOMEZ,EXG,664,0.73,1.08,Battu
38,06,61335,316,1201,62852,28202,91054,M. Pierre FABRE,EXG,185,0.2,0.3,Battu
38,07,67773,387,1033,69193,27807,97000,M. Benoît AUGUSTE,RN,28531,29.41,42.1,Qualif
38,07,67773,387,1033,69193,27807,97000,M. Yannick NEUDER,LR,18678,19.26,27.56,Qualif
38,07,67773,387,1033,69193,27807,97000,Mme Dominique DICHARD,UG,13427,13.84,19.81,Qualif
38,07,67773,387,1033,69193,27807,97000,Mme Helena CHESSER,ENS,6507,6.71,9.6,Battu
38,07,67773,387,1033,69193,27807,97000,M. Bruno PERRODIN,EXG,630,0.65,0.93,Battu
38,08,57232,336,1026,58594,24248,82842,Mme Hanane MANSOURI,UXD,22847,27.58,39.92,Qualif
38,08,57232,336,1026,58594,24248,82842,Mme Cécile MICHEL,UG,14021,16.92,24.5,Qualif
38,08,57232,336,1026,58594,24248,82842,Mme Caroline ABADIE,ENS,11727,14.16,20.49,Qualif
38,08,57232,336,1026,58594,24248,82842,M. Jean-Claude LASSALLE,LR,7923,9.56,13.84,Battu
38,08,57232,336,1026,58594,24248,82842,M. Jacques LACAILLE,EXG,623,0.75,1.09,Battu
38,08,57232,336,1026,58594,24248,82842,Mme Aurore GALVES,DIV,91,0.11,0.16,Battu
38,09,70825,309,1447,72581,28739,101320,Mme Cécile BENE,RN,24106,23.79,34.04,Qualif
38,09,70825,309,1447,72581,28739,101320,Mme Sandrine NOSBÉ,UG,19825,19.57,27.99,Qualif
38,09,70825,309,1447,72581,28739,101320,Mme Élodie JACQUIER-LAFORGE,ENS,19307,19.06,27.26,Qualif
38,09,70825,309,1447,72581,28739,101320,Mme Héloïse BARADEL,LR,5468,5.4,7.72,Battu
38,09,70825,309,1447,72581,28739,101320,Mme Gaelle OFFRANC PIRET,ECO,833,0.82,1.18,Battu
38,09,70825,309,1447,72581,28739,101320,Mme Claude DETROYAT,EXG,756,0.75,1.07,Battu
38,09,70825,309,1447,72581,28739,101320,M. Salvador VERO,REC,397,0.39,0.56,Battu
38,09,70825,309,1447,72581,28739,101320,M. Valentin RADLO,DIV,124,0.12,0.18,Battu
38,09,70825,309,1447,72581,28739,101320,Mme Emma VASSAL,EXG,9,0.01,0.01,Battu
38,10,66186,383,1149,67718,31677,99395,M. Thierry PEREZ,RN,28348,28.52,42.83,Qualif
38,10,66186,383,1149,67718,31677,99395,Mme Joëlle RICHOL,UG,16833,16.94,25.43,Qualif
38,10,66186,383,1149,67718,31677,99395,Mme Marjolaine MEYNIER-MILLEFERT,ENS,14688,14.78,22.19,Qualif
38,10,66186,383,1149,67718,31677,99395,M. Aurélien LEPRETRE,LR,5318,5.35,8.03,Battu
38,10,66186,383,1149,67718,31677,99395,M. Clément BORDES,EXG,999,1.01,1.51,Battu
39,01,44884,489,1018,46391,18534,64925,Mme Valérie GRABY,RN,17517,26.98,39.03,Qualif
39,01,44884,489,1018,46391,18534,64925,Mme Danielle BRULEBOIS,ENS,16231,25,36.16,Qualif
39,01,44884,489,1018,46391,18534,64925,M. Anthony BRONDEL,UG,10350,15.94,23.06,Qualif
39,01,44884,489,1018,46391,18534,64925,Mme Johanne MOREL,EXG,786,1.21,1.75,Battu
39,02,37595,356,766,38717,17006,55723,Mme Marie-Christine DALLOZ,LR,14507,26.03,38.59,Qualif
39,02,37595,356,766,38717,17006,55723,M. Thierry MOSCA,RN,12315,22.1,32.76,Qualif
39,02,37595,356,766,38717,17006,55723,Mme Evelyne TERNANT,UG,9303,16.7,24.75,Qualif
39,02,37595,356,766,38717,17006,55723,M. Patrick LANCON,DSV,694,1.25,1.85,Battu
39,02,37595,356,766,38717,17006,55723,M. André BIGOT,REC,390,0.7,1.04,Battu
39,02,37595,356,766,38717,17006,55723,M. Christian MARCHET,EXG,386,0.69,1.03,Battu
39,03,48710,411,789,49910,20295,70205,Mme Aurore VUILLEMIN-PLANCON,RN,19354,27.57,39.73,Qualif
39,03,48710,411,789,49910,20295,70205,Mme Justine GRUET,LR,16727,23.83,34.34,Qualif
39,03,48710,411,789,49910,20295,70205,M. Hervé PRAT,UG,11833,16.85,24.29,Qualif
39,03,48710,411,789,49910,20295,70205,Mme Dominique REVOY,EXG,796,1.13,1.63,Battu
40,01,75576,725,1714,78015,31682,109697,Mme Veronique FOSSEY,RN,28138,25.65,37.23,Qualif
40,01,75576,725,1714,78015,31682,109697,Mme Geneviève DARRIEUSSECQ,ENS,21353,19.47,28.25,Qualif
40,01,75576,725,1714,78015,31682,109697,Mme Marie-Laure LAFARGUE,UG,20466,18.66,27.08,Qualif
40,01,75576,725,1714,78015,31682,109697,Mme Fabienne CHRIT,LR,3343,3.05,4.42,Battu
40,01,75576,725,1714,78015,31682,109697,M. Jean Claude BON,EXG,852,0.78,1.13,Battu
40,01,75576,725,1714,78015,31682,109697,M. Dominique JARREAU,DVC,720,0.66,0.95,Battu
40,01,75576,725,1714,78015,31682,109697,Mme Isabelle HENAFF,REC,700,0.64,0.93,Battu
40,01,75576,725,1714,78015,31682,109697,M. Degny Hermann AMESSAN,DVC,4,0,0.01,Battu
40,02,86700,899,1886,89485,35132,124617,M. Ludovic BIESBROUCK,RN,28264,22.68,32.6,Qualif
40,02,86700,899,1886,89485,35132,124617,M. Lionel CAUSSE,ENS,26051,20.9,30.05,Qualif
40,02,86700,899,1886,89485,35132,124617,M. Jean-Marc LESPADE,UG,24645,19.78,28.43,Qualif
40,02,86700,899,1886,89485,35132,124617,M. Marc VERNIER,LR,4625,3.71,5.33,Battu
40,02,86700,899,1886,89485,35132,124617,Mme Dominique LECUONA,REG,1358,1.09,1.57,Battu
40,02,86700,899,1886,89485,35132,124617,M. Stéphane DAVID,REC,918,0.74,1.06,Battu
40,02,86700,899,1886,89485,35132,124617,M. Pascal DEMANGEOT,EXG,839,0.67,0.97,Battu
40,03,70706,877,1583,73166,26854,100020,M. Boris VALLAUD,UG,26235,26.23,37.1,Qualif
40,03,70706,877,1583,73166,26854,100020,Mme Sylvie FRANCESCHINI,RN,25165,25.16,35.59,Qualif
40,03,70706,877,1583,73166,26854,100020,M. Tom GILLET DUFFRECHOU,ENS,11310,11.31,16,Battu
40,03,70706,877,1583,73166,26854,100020,M. Brice SAINT-CRICQ,LR,5078,5.08,7.18,Battu
40,03,70706,877,1583,73166,26854,100020,Mme Christelle LASSORT,DVC,1141,1.14,1.61,Battu
40,03,70706,877,1583,73166,26854,100020,M. Christian DELFOSSE,REC,813,0.81,1.15,Battu
40,03,70706,877,1583,73166,26854,100020,Mme Carole VOUTAZ,EXG,513,0.51,0.73,Battu
40,03,70706,877,1583,73166,26854,100020,M. Matèu RICHARD,REG,451,0.45,0.64,Battu
41,01,54148,483,1221,55852,26854,82706,Mme Marine BARDET,RN,19069,23.06,35.22,Qualif
41,01,54148,483,1221,55852,26854,82706,M. Marc FESNEAU,ENS,18711,22.62,34.56,Qualif
41,01,54148,483,1221,55852,26854,82706,M. Reda BELKADI,DVG,8311,10.05,15.35,Battu
41,01,54148,483,1221,55852,26854,82706,M. Pierre Gilles PARRA,LR,3220,3.89,5.95,Battu
41,01,54148,483,1221,55852,26854,82706,M. Gildas VIEIRA,DVC,2867,3.47,5.29,Battu
41,01,54148,483,1221,55852,26854,82706,M. Alain LOMBARD,EXG,1828,2.21,3.38,Battu
41,01,54148,483,1221,55852,26854,82706,M. François DASSONNEVILLE,DIV,138,0.17,0.25,Battu
41,01,54148,483,1221,55852,26854,82706,M. Jean-Marc TRAN,DIV,4,0,0.01,Battu
41,02,51512,680,1903,54095,26185,80280,M. Roger CHUDEAU,RN,25611,31.9,49.72,Qualif
41,02,51512,680,1903,54095,26185,80280,M. Nils AUCANTE,DVD,10340,12.88,20.07,Qualif
41,02,51512,680,1903,54095,26185,80280,Mme Sylvie MAYER,UG,10027,12.49,19.47,Battu
41,02,51512,680,1903,54095,26185,80280,M. Alexandre GUILLEMAUD,UDI,2803,3.49,5.44,Battu
41,02,51512,680,1903,54095,26185,80280,M. Hervé LANCELOT,REC,1719,2.14,3.34,Battu
41,02,51512,680,1903,54095,26185,80280,Mme Caroline MAIDON,EXG,966,1.2,1.88,Battu
41,02,51512,680,1903,54095,26185,80280,Mme Bénédicte DE SAINT PIERRE,DVD,46,0.06,0.09,Battu
41,02,51512,680,1903,54095,26185,80280,M. Eric FOUQUE,DIV,0,0,0,Battu
41,03,55217,565,1190,56972,24082,81054,Mme Virginia DE OLIVEIRA,RN,22674,27.97,41.06,Qualif
41,03,55217,565,1190,56972,24082,81054,M. Christophe MARION,ENS,20014,24.69,36.25,Qualif
41,03,55217,565,1190,56972,24082,81054,M. Noé PETIT,UG,10795,13.32,19.55,Qualif
41,03,55217,565,1190,56972,24082,81054,M. Claude LAMY,EXG,986,1.22,1.79,Battu
41,03,55217,565,1190,56972,24082,81054,M. Alexandre BONNASSIEUX,REC,748,0.92,1.35,Battu
42,01,41588,250,585,42423,21540,63963,M. Pierrick COURBON,UG,16778,26.23,40.34,Qualif
42,01,41588,250,585,42423,21540,63963,Mme Marie SIMON,RN,13296,20.79,31.97,Qualif
42,01,41588,250,585,42423,21540,63963,M. Quentin BATAILLON,ENS,9864,15.42,23.72,Qualif
42,01,41588,250,585,42423,21540,63963,M. Xavier KEMLIN,DVD,811,1.27,1.95,Battu
42,01,41588,250,585,42423,21540,63963,M. Romain BROSSARD,EXG,473,0.74,1.14,Battu
42,01,41588,250,585,42423,21540,63963,M. François CHORD,DVD,366,0.57,0.88,Battu
42,02,31679,178,474,32331,18558,50889,Mme Andrée TAURINYA,UG,13652,26.83,43.09,Qualif
42,02,31679,178,474,32331,18558,50889,M. Hervé BREUIL,RN,8595,16.89,27.13,Qualif
42,02,31679,178,474,32331,18558,50889,M. Eric LE JAOUEN,UDI,7310,14.36,23.08,Qualif
42,02,31679,178,474,32331,18558,50889,M. Martial MOSSMANN,DVC,871,1.71,2.75,Battu
42,02,31679,178,474,32331,18558,50889,Mme Nathalie DOUSPIS,ECO,650,1.28,2.05,Battu
42,02,31679,178,474,32331,18558,50889,Mme Sophie DIETERICH,EXG,439,0.86,1.39,Battu
42,02,31679,178,474,32331,18558,50889,M. Quentin FONTVIEILLE,DVC,162,0.32,0.51,Battu
42,03,55791,240,1310,57341,27063,84404,Mme Angelina LA MARCA,RN,22813,27.03,40.89,Qualif
42,03,55791,240,1310,57341,27063,84404,M. Emmanuel MANDON,ENS,16243,19.24,29.11,Qualif
42,03,55791,240,1310,57341,27063,84404,M. Vincent BONY,UG,15254,18.07,27.34,Qualif
42,03,55791,240,1310,57341,27063,84404,M. Rachid DAOUD,DVG,754,0.89,1.35,Battu
42,03,55791,240,1310,57341,27063,84404,Mme Pauline HUSSEINI,EXG,727,0.86,1.3,Battu
42,04,70470,458,1513,72441,32052,104493,M. Gerbert RAMBAUD,RN,28753,27.52,40.8,Qualif
42,04,70470,458,1513,72441,32052,104493,Mme Sylvie BONNET,LR,21649,20.72,30.72,Qualif
42,04,70470,458,1513,72441,32052,104493,M. Bernard PAEMELAERE,UG,18700,17.9,26.54,Qualif
42,04,70470,458,1513,72441,32052,104493,Mme Nora IBBARI,EXG,1368,1.31,1.94,Battu
42,05,71050,497,1187,72734,28855,101589,M. Antoine VERMOREL-MARQUES,LR,29832,29.37,41.99,Qualif
42,05,71050,497,1187,72734,28855,101589,Mme Sandrine GRANGER,RN,25644,25.24,36.09,Qualif
42,05,71050,497,1187,72734,28855,101589,M. Ismaël STEVENSON,UG,13039,12.84,18.35,Qualif
42,05,71050,497,1187,72734,28855,101589,Mme Florence NAYME,ECO,956,0.94,1.35,Battu
42,05,71050,497,1187,72734,28855,101589,Mme Edith ROCHE,EXG,726,0.71,1.02,Battu
42,05,71050,497,1187,72734,28855,101589,M. Robert LACHAUD,REC,614,0.6,0.86,Battu
42,05,71050,497,1187,72734,28855,101589,M. Yann ESTEVENY,EXD,239,0.24,0.34,Battu
42,06,78105,581,1548,80234,31623,111857,M. Grégoire GRANGER,RN,31016,27.73,39.71,Qualif
42,06,78105,581,1548,80234,31623,111857,M. Jean-Pierre TAITE,LR,21724,19.42,27.81,Qualif
42,06,78105,581,1548,80234,31623,111857,Mme Marie-Paule OLIVE,UG,13472,12.04,17.25,Battu
42,06,78105,581,1548,80234,31623,111857,M. Alexandre SILVA,DVC,9721,8.69,12.45,Battu
42,06,78105,581,1548,80234,31623,111857,M. Yves PETIOT,EXG,720,0.64,0.92,Battu
42,06,78105,581,1548,80234,31623,111857,M. Norbert TRICHARD,EXG,502,0.45,0.64,Battu
42,06,78105,581,1548,80234,31623,111857,Mme Sandra HAURY,ECO,480,0.43,0.61,Battu
42,06,78105,581,1548,80234,31623,111857,M. Yvan GUY-MERCIER,REC,470,0.42,0.6,Battu
43,01,73398,447,1021,74866,27850,102716,M. Laurent WAUQUIEZ,LR,27013,26.3,36.8,Qualif
43,01,73398,447,1021,74866,27850,102716,M. Alexandre HEUZEY,RN,25091,24.43,34.18,Qualif
43,01,73398,447,1021,74866,27850,102716,Mme Celline GACON,UG,13694,13.33,18.66,Qualif
43,01,73398,447,1021,74866,27850,102716,Mme Cécile Marcelle GALLIEN,ENS,6932,6.75,9.44,Battu
43,01,73398,447,1021,74866,27850,102716,Mme Electre DRACOS,EXG,668,0.65,0.91,Battu
43,02,55758,481,834,57073,22317,79390,M. Jean-Pierre VIGIER,LR,21573,27.17,38.69,Qualif
43,02,55758,481,834,57073,22317,79390,Mme Suzanne Maryse Denise FOURETS,RN,17885,22.53,32.08,Qualif
43,02,55758,481,834,57073,22317,79390,M. Andre Antoine Célestin CHAPAVEIRE,UG,10898,13.73,19.55,Qualif
43,02,55758,481,834,57073,22317,79390,Mme Patricia Pierrette GIRE-JOUBERT,ENS,4607,5.8,8.26,Battu
43,02,55758,481,834,57073,22317,79390,M. Antoine BREBION,EXG,795,1,1.43,Battu
44,01,54798,181,1193,56172,21170,77342,M. Karim BENBRAHIM,UG,23671,30.61,43.2,Qualif
44,01,54798,181,1193,56172,21170,77342,M. Mounir BELHAMITI,ENS,20488,26.49,37.39,Qualif
44,01,54798,181,1193,56172,21170,77342,M. Bryan PECQUEUR,RN,9937,12.85,18.13,Qualif
44,01,54798,181,1193,56172,21170,77342,Mme Hélène DEFRANCE,EXG,521,0.67,0.95,Battu
44,01,54798,181,1193,56172,21170,77342,Mme Betty COLLOBER,EXG,181,0.23,0.33,Battu
44,02,66463,266,832,67561,23971,91532,M. Andy KERBRAT,UG,34341,37.52,51.67,Elu
44,02,66463,266,832,67561,23971,91532,Mme Valérie OPPELT,ENS,17744,19.39,26.7,Battu
44,02,66463,266,832,67561,23971,91532,Mme Nolwenn FER,RN,9157,10,13.78,Battu
44,02,66463,266,832,67561,23971,91532,Mme Louisa AMROUCHE,LR,3893,4.25,5.86,Battu
44,02,66463,266,832,67561,23971,91532,M. Adrien COPROS,DVG,786,0.86,1.18,Battu
44,02,66463,266,832,67561,23971,91532,M. Nicolas BAZILLE,EXG,542,0.59,0.82,Battu
44,02,66463,266,832,67561,23971,91532,M. Nicolas VABRE,EXG,0,0,0,Battu
44,02,66463,266,832,67561,23971,91532,Mme Zora CHIGNOLE,DIV,0,0,0,Battu
44,03,65728,303,1242,67273,30116,97389,Mme Ségolène AMIOT,UG,29285,30.07,44.55,Qualif
44,03,65728,303,1242,67273,30116,97389,M. Matthieu ANNEREAU,ENS,16147,16.58,24.57,Qualif
44,03,65728,303,1242,67273,30116,97389,Mme Laurie ARC,RN,13425,13.78,20.43,Qualif
44,03,65728,303,1242,67273,30116,97389,Mme Sophie VAN GOETHEM,LR,4143,4.25,6.3,Battu
44,03,65728,303,1242,67273,30116,97389,M. Gildas PERROT,REG,1896,1.95,2.88,Battu
44,03,65728,303,1242,67273,30116,97389,Mme Hélène DOLIDON,EXG,832,0.85,1.27,Battu
44,04,65381,423,984,66788,26440,93228,Mme Julie LAERNOES,UG,30619,32.84,46.83,Qualif
44,04,65381,423,984,66788,26440,93228,Mme Aude AMADOU,ENS,14815,15.89,22.66,Qualif
44,04,65381,423,984,66788,26440,93228,Mme Gaëlle PINEAU,RN,13116,14.07,20.06,Qualif
44,04,65381,423,984,66788,26440,93228,Mme Astrid LUSSON,DVD,5450,5.85,8.34,Battu
44,04,65381,423,984,66788,26440,93228,M. Stéphane PELLEGRINI,EXG,788,0.85,1.21,Battu
44,04,65381,423,984,66788,26440,93228,M. François OLLÉON,ECO,593,0.64,0.91,Battu
44,04,65381,423,984,66788,26440,93228,M. Mattis GAUVIN,EXG,0,0,0,Battu
44,05,91897,639,1830,94366,33612,127978,M. Fabrice ROUSSEL,UG,34673,27.09,37.73,Qualif
44,05,91897,639,1830,94366,33612,127978,Mme Sarah EL HAÏRY,ENS,33241,25.97,36.17,Qualif
44,05,91897,639,1830,94366,33612,127978,M. Bruno COMBY,UXD,22722,17.75,24.73,Qualif
44,05,91897,639,1830,94366,33612,127978,Mme Emmanuelle CLOPEAU,EXG,1261,0.99,1.37,Battu
44,06,78794,778,1919,81491,35797,117288,M. Jean-Claude RAUX,UG,26919,22.95,34.16,Qualif
44,06,78794,778,1919,81491,35797,117288,M. Julio PICHON,RN,25886,22.07,32.85,Qualif
44,06,78794,778,1919,81491,35797,117288,M. Alain HUNAULT,DVD,22993,19.6,29.18,Qualif
44,06,78794,778,1919,81491,35797,117288,Mme Fannie LEJAU,DSV,1671,1.42,2.12,Battu
44,06,78794,778,1919,81491,35797,117288,Mme Marie-Paule CATHELINE,EXG,1325,1.13,1.68,Battu
44,07,82445,640,2478,85563,33383,118946,Mme Sandrine JOSSO,ENS,23489,19.75,28.49,Qualif
44,07,82445,640,2478,85563,33383,118946,M. Michel HUNAULT,UXD,23210,19.51,28.15,Qualif
44,07,82445,640,2478,85563,33383,118946,Mme Véronique MAHÉ,UG,19881,16.71,24.11,Qualif
44,07,82445,640,2478,85563,33383,118946,M. Bertrand PLOUVIER,LR,11616,9.77,14.09,Battu
44,07,82445,640,2478,85563,33383,118946,M. Gaël BOURDEAU,DSV,1595,1.34,1.93,Battu
44,07,82445,640,2478,85563,33383,118946,Mme Sophie CORBIN,REC,1426,1.2,1.73,Battu
44,07,82445,640,2478,85563,33383,118946,Mme Marie-France BELIN,EXG,1228,1.03,1.49,Battu
44,08,59115,392,945,60452,30695,91147,M. Matthias TAVEL,UG,18317,20.1,30.99,Qualif
44,08,59115,392,945,60452,30695,91147,M. Gauthier BOUCHET,RN,17065,18.72,28.87,Qualif
44,08,59115,392,945,60452,30695,91147,Mme Audrey DUFEU,ENS,11991,13.16,20.28,Qualif
44,08,59115,392,945,60452,30695,91147,M. Xavier PERRIN,DVG,8327,9.14,14.09,Battu
44,08,59115,392,945,60452,30695,91147,Mme Florence BEUVELET,LR,2525,2.77,4.27,Battu
44,08,59115,392,945,60452,30695,91147,M. Eddy LE BELLER,EXG,890,0.98,1.51,Battu
44,09,91804,875,1943,94622,38045,132667,M. Jean-Michel BRARD,DVD,29952,22.58,32.63,Qualif
44,09,91804,875,1943,94622,38045,132667,M. Bastian MALDINEY,RN,29841,22.49,32.51,Qualif
44,09,91804,875,1943,94622,38045,132667,Mme Hélène MACON,UG,24197,18.24,26.36,Qualif
44,09,91804,875,1943,94622,38045,132667,Mme Annie LE GAL LA SALLE,ECO,2713,2.04,2.96,Battu
44,09,91804,875,1943,94622,38045,132667,Mme Aurore PAPOT,DSV,1636,1.23,1.78,Battu
44,09,91804,875,1943,94622,38045,132667,M. Laurent CHOMARD,REC,1209,0.91,1.32,Battu
44,09,91804,875,1943,94622,38045,132667,Mme Annie HERVO,EXG,1134,0.85,1.24,Battu
44,09,91804,875,1943,94622,38045,132667,M. Yannis BIZIEN,REG,1122,0.85,1.22,Battu
44,10,90124,744,1807,92675,33656,126331,Mme Sophie ERRANTE,ENS,27555,21.81,30.57,Qualif
44,10,90124,744,1807,92675,33656,126331,M. Maxime VIANCIN,UG,25055,19.83,27.8,Qualif
44,10,90124,744,1807,92675,33656,126331,Mme Stéphanie COTREL,RN,23574,18.66,26.16,Qualif
44,10,90124,744,1807,92675,33656,126331,M. Xavier RINEAU,LR,8889,7.04,9.86,Battu
44,10,90124,744,1807,92675,33656,126331,M. Bruno CHEVALIER,DVG,2947,2.33,3.27,Battu
44,10,90124,744,1807,92675,33656,126331,M. Jacques COUSIN,DSV,1211,0.96,1.34,Battu
44,10,90124,744,1807,92675,33656,126331,Mme Emmanuèle GARDAIR,EXG,893,0.71,0.99,Battu
45,01,53079,282,803,54164,24145,78309,Mme Stéphanie RIST,ENS,16775,21.42,31.6,Qualif
45,01,53079,282,803,54164,24145,78309,Mme Ghislaine KOUNOWSKI,UG,16706,21.33,31.47,Qualif
45,01,53079,282,803,54164,24145,78309,Mme Tiffanie RABAULT,RN,14880,19,28.03,Qualif
45,01,53079,282,803,54164,24145,78309,M. Guillaume CHASSANG,DVC,3620,4.62,6.82,Battu
45,01,53079,282,803,54164,24145,78309,Mme Nicole MAURICE,REC,659,0.84,1.24,Battu
45,01,53079,282,803,54164,24145,78309,M. Claude TREPKA,EXG,439,0.56,0.83,Battu
45,02,57602,398,836,58836,29765,88601,Mme Elodie BABIN,RN,18957,21.4,32.91,Qualif
45,02,57602,398,836,58836,29765,88601,M. Emmanuel DUPLESSY,UG,16148,18.23,28.03,Qualif
45,02,57602,398,836,58836,29765,88601,Mme Caroline JANVIER,ENS,13263,14.97,23.03,Qualif
45,02,57602,398,836,58836,29765,88601,M. Cyril COLAS,LR,4527,5.11,7.86,Battu
45,02,57602,398,836,58836,29765,88601,M. Yann CHAILLOU,DVG,1951,2.2,3.39,Battu
45,02,57602,398,836,58836,29765,88601,M. Bruno CARRANI,ECO,1474,1.66,2.56,Battu
45,02,57602,398,836,58836,29765,88601,Mme Marie-Odile DUVILLARD,REC,716,0.81,1.24,Battu
45,02,57602,398,836,58836,29765,88601,Mme Farida MEGDOUD,EXG,388,0.44,0.67,Battu
45,02,57602,398,836,58836,29765,88601,M. Ahmed AACHBOUN,DVG,178,0.2,0.31,Battu
45,03,46943,382,1005,48330,22115,70445,Mme Mathilde PARIS,RN,21373,30.34,45.53,Qualif
45,03,46943,382,1005,48330,22115,70445,Mme Constance DE PÉLICHY,DVD,15041,21.35,32.04,Qualif
45,03,46943,382,1005,48330,22115,70445,M. Clément VERDE,UG,9089,12.9,19.36,Qualif
45,03,46943,382,1005,48330,22115,70445,M. Thomas MAURICE,REC,792,1.12,1.69,Battu
45,03,46943,382,1005,48330,22115,70445,M. Michel NAULIN,EXG,648,0.92,1.38,Battu
45,04,46785,305,955,48045,26054,74099,M. Thomas MÉNAGÉ,RN,23231,31.35,49.65,Qualif
45,04,46785,305,955,48045,26054,74099,M. Bruno NOTTIN,UG,9889,13.35,21.14,Qualif
45,04,46785,305,955,48045,26054,74099,Mme Mélusine HARLÉ,ENS,7029,9.49,15.02,Battu
45,04,46785,305,955,48045,26054,74099,M. Ariel LÉVY,LR,5537,7.47,11.83,Battu
45,04,46785,305,955,48045,26054,74099,Mme Dominique CLERGUE,EXG,551,0.74,1.18,Battu
45,04,46785,305,955,48045,26054,74099,M. Georges LOUBERT,REC,535,0.72,1.14,Battu
45,04,46785,305,955,48045,26054,74099,Mme Françoise ROCHE,DIV,13,0.02,0.03,Battu
45,05,48177,365,793,49335,24246,73581,M. Jean-Lin LACAPELLE,RN,20893,28.39,43.37,Qualif
45,05,48177,365,793,49335,24246,73581,M. Anthony BROSSE,ENS,10604,14.41,22.01,Qualif
45,05,48177,365,793,49335,24246,73581,Mme Anne-Laure BOUTET,UG,9524,12.94,19.77,Qualif
45,05,48177,365,793,49335,24246,73581,M. Benjamin QUELIN,DVD,4817,6.55,10,Battu
45,05,48177,365,793,49335,24246,73581,Mme Christine BIARDEAU,DIV,1259,1.71,2.61,Battu
45,05,48177,365,793,49335,24246,73581,Mme Martine ROBERT,REC,651,0.88,1.35,Battu
45,05,48177,365,793,49335,24246,73581,Mme Céline SOTTEJEAU,EXG,429,0.58,0.89,Battu
45,06,51090,340,867,52297,23787,76084,M. Anthony ZELLER,RN,16253,21.36,31.81,Qualif
45,06,51090,340,867,52297,23787,76084,M. Richard RAMOS,ENS,15635,20.55,30.6,Qualif
45,06,51090,340,867,52297,23787,76084,M. Christophe LAVIALLE,UG,15176,19.95,29.7,Qualif
45,06,51090,340,867,52297,23787,76084,M. Jean-Luc POISSON,LR,2239,2.94,4.38,Battu
45,06,51090,340,867,52297,23787,76084,Mme Isabelle LAMARQUE,REC,664,0.87,1.3,Battu
45,06,51090,340,867,52297,23787,76084,Mme Annie BERTHAULT-KORZHYK,DSV,595,0.78,1.16,Battu
45,06,51090,340,867,52297,23787,76084,M. David CHOQUEL,EXG,528,0.69,1.03,Battu
46,01,52503,575,598,53676,19371,73047,M. Aurélien PRADIÉ,LR,22180,30.36,42.25,Qualif
46,01,52503,575,598,53676,19371,73047,Mme Elsa BOUGEARD,UG,12775,17.49,24.33,Qualif
46,01,52503,575,598,53676,19371,73047,Mme Slavka MIHAYLOVA,RN,12108,16.58,23.06,Qualif
46,01,52503,575,598,53676,19371,73047,M. Frédéric DECREMPS,ENS,4689,6.42,8.93,Battu
46,01,52503,575,598,53676,19371,73047,M. François TESSON,REC,398,0.54,0.76,Battu
46,01,52503,575,598,53676,19371,73047,M. Ghislain DOMENECH,EXG,353,0.48,0.67,Battu
46,02,47303,880,1114,49297,17023,66320,M. Christophe PROENÇA,UG,18079,27.26,38.22,Qualif
46,02,47303,880,1114,49297,17023,66320,M. Gérard Raymond BLANCHET,RN,14369,21.67,30.38,Qualif
46,02,47303,880,1114,49297,17023,66320,Mme Huguette TIEGNA,ENS,12752,19.23,26.96,Qualif
46,02,47303,880,1114,49297,17023,66320,M. Daniel PAGET,DIV,1237,1.87,2.62,Battu
46,02,47303,880,1114,49297,17023,66320,Mme Marie-Michèle VIAU,EXG,607,0.92,1.28,Battu
46,02,47303,880,1114,49297,17023,66320,M. Rabah BOUGUERRA,DVG,259,0.39,0.55,Battu
47,01,60389,841,1456,62686,25872,88558,M. Sébastien DELBOSQ,RN,26034,29.4,43.11,Qualif
47,01,60389,841,1456,62686,25872,88558,M. Michel LAUZZANA,ENS,17155,19.37,28.41,Qualif
47,01,60389,841,1456,62686,25872,88558,M. Paul VO VAN,UG,15479,17.48,25.63,Qualif
47,01,60389,841,1456,62686,25872,88558,M. Patrice CUQUEL,REG,1021,1.15,1.69,Battu
47,01,60389,841,1456,62686,25872,88558,M. Mohamed EL MARBATI,EXG,700,0.79,1.16,Battu
47,02,51269,878,1196,53343,23601,76944,Mme Hélène LAPORTE,RN,25281,32.86,49.31,Qualif
47,02,51269,878,1196,53343,23601,76944,M. Christophe COURREGELONGUE,UG,13787,17.92,26.89,Qualif
47,02,51269,878,1196,53343,23601,76944,M. Jean-Marie LENZI,ENS,11272,14.65,21.99,Qualif
47,02,51269,878,1196,53343,23601,76944,Mme Nathalie LAMBOLEZ,EXG,929,1.21,1.81,Battu
47,03,51526,578,900,53004,22782,75786,Mme Annick COUSIN,RN,21168,27.93,41.08,Qualif
47,03,51526,578,900,53004,22782,75786,M. Guillaume LEPERS,DVD,12876,16.99,24.99,Qualif
47,03,51526,578,900,53004,22782,75786,M. Xavier CZAPLA,UG,9460,12.48,18.36,Battu
47,03,51526,578,900,53004,22782,75786,M. Jérôme CAHUZAC,DVG,7501,9.9,14.56,Battu
47,03,51526,578,900,53004,22782,75786,Mme Bernadette GASC,EXG,521,0.69,1.01,Battu
48,01,43478,451,916,44845,14919,59764,Mme Sophie PANTEL,UG,15292,25.59,35.17,Qualif
48,01,43478,451,916,44845,14919,59764,M. Luc-Etienne GOUSSEAU,RN,14743,24.67,33.91,Qualif
48,01,43478,451,916,44845,14919,59764,M. Pierre MOREL A L'HUISSIER,DVD,10451,17.49,24.04,Qualif
48,01,43478,451,916,44845,14919,59764,M. Michel GUIRAL,DIV,2627,4.4,6.04,Battu
48,01,43478,451,916,44845,14919,59764,Mme Annie SOUCHON,EXG,284,0.48,0.65,Battu
48,01,43478,451,916,44845,14919,59764,M. Dja ZIDOUN,DVG,81,0.14,0.19,Battu
49,01,60540,518,1016,62074,26601,88675,M. François GERNIGON,ENS,21087,23.78,34.83,Qualif
49,01,60540,518,1016,62074,26601,88675,Mme Elsa RICHARD,UG,20475,23.09,33.82,Qualif
49,01,60540,518,1016,62074,26601,88675,M. Hugo LOUVIGNE,RN,13995,15.78,23.12,Qualif
49,01,60540,518,1016,62074,26601,88675,Mme Séverine LÉCUYER,LR,3736,4.21,6.17,Battu
49,01,60540,518,1016,62074,26601,88675,Mme Marie Louise DUPAS,EXG,642,0.72,1.06,Battu
49,01,60540,518,1016,62074,26601,88675,Mme Roselyne PRUNIERE,REC,432,0.49,0.71,Battu
49,01,60540,518,1016,62074,26601,88675,M. Anthony GOUAS,EXG,173,0.2,0.29,Battu
49,02,65744,544,1325,67613,27970,95583,Mme Stella DUPONT,ENS,21761,22.77,33.1,Qualif
49,02,65744,544,1325,67613,27970,95583,M. Léo METAYER,UG,18621,19.48,28.32,Qualif
49,02,65744,544,1325,67613,27970,95583,M. Thomas BRISSEAU,RN,15945,16.68,24.25,Qualif
49,02,65744,544,1325,67613,27970,95583,M. Benoît TRIOT,LR,5864,6.13,8.92,Battu
49,02,65744,544,1325,67613,27970,95583,M. Bertrand SALQUAIN,DVC,2719,2.84,4.14,Battu
49,02,65744,544,1325,67613,27970,95583,M. Philippe LEBRUN,EXG,834,0.87,1.27,Battu
49,03,48481,470,918,49869,22879,72748,M. Edouard BOURGEAULT,RN,18344,25.22,37.84,Qualif
49,03,48481,470,918,49869,22879,72748,Mme Anne-Laure BLIN,LR,11572,15.91,23.87,Qualif
49,03,48481,470,918,49869,22879,72748,M. Patrick ALEXANDRE,UG,9656,13.27,19.92,Qualif
49,03,48481,470,918,49869,22879,72748,M. Simon HOLLEY,ENS,8168,11.23,16.85,Battu
49,03,48481,470,918,49869,22879,72748,Mme Patricia PEILLON,EXG,741,1.02,1.53,Battu
49,04,51621,586,1085,53292,22834,76126,Mme Aurore LAHONDÈS,RN,18014,23.66,34.9,Qualif
49,04,51621,586,1085,53292,22834,76126,Mme Laëtitia SAINT-PAUL,ENS,18001,23.65,34.87,Qualif
49,04,51621,586,1085,53292,22834,76126,Mme Charlyne BOUVET,UG,10629,13.96,20.59,Qualif
49,04,51621,586,1085,53292,22834,76126,M. Frédéric MORTIER,LR,3455,4.54,6.69,Battu
49,04,51621,586,1085,53292,22834,76126,Mme Delphine HAMON,DSV,769,1.01,1.49,Battu
49,04,51621,586,1085,53292,22834,76126,Mme Sylvie GERET,EXG,750,0.99,1.45,Battu
49,04,51621,586,1085,53292,22834,76126,M. Nicolas VITASSE,EXG,3,0,0.01,Battu
49,05,52604,529,1207,54340,25757,80097,M. Denis MASSEGLIA,ENS,17730,22.14,33.7,Qualif
49,05,52604,529,1207,54340,25757,80097,M. Gilles BOURDOULEIX,UXD,16066,20.06,30.54,Qualif
49,05,52604,529,1207,54340,25757,80097,Mme France MOREAU,UG,11220,14.01,21.33,Qualif
49,05,52604,529,1207,54340,25757,80097,M. Jacquelin LIGOT,LR,5362,6.69,10.19,Battu
49,05,52604,529,1207,54340,25757,80097,M. Frédéric GUYARD,DSV,822,1.03,1.56,Battu
49,05,52604,529,1207,54340,25757,80097,M. Didier TESTU,EXG,821,1.03,1.56,Battu
49,05,52604,529,1207,54340,25757,80097,Mme Véronique ESTANG,REC,583,0.73,1.11,Battu
49,06,67389,766,1618,69773,29883,99656,Mme Nicole DUBRE CHIRAT,ENS,23776,23.86,35.28,Qualif
49,06,67389,766,1618,69773,29883,99656,M. Tim PAVAGEAU,RN,19422,19.49,28.82,Qualif
49,06,67389,766,1618,69773,29883,99656,Mme Sylvie GABIN,UG,16707,16.76,24.79,Qualif
49,06,67389,766,1618,69773,29883,99656,Mme Anaëlle CHAUSSIVERT,LR,5142,5.16,7.63,Battu
49,06,67389,766,1618,69773,29883,99656,M. Eric MERCIER,DSV,1243,1.25,1.84,Battu
49,06,67389,766,1618,69773,29883,99656,M. Yann LE DIAGON,EXG,1099,1.1,1.63,Battu
49,07,57716,544,1305,59565,24926,84491,M. Philippe BOLO,ENS,19541,23.13,33.86,Qualif
49,07,57716,544,1305,59565,24926,84491,M. Guillaume JOUANNEAU,UG,16778,19.86,29.07,Qualif
49,07,57716,544,1305,59565,24926,84491,Mme Clémence LASCAUD,RN,15802,18.7,27.38,Qualif
49,07,57716,544,1305,59565,24926,84491,Mme Sandrine BOULLAIS CHALLIER,LR,3320,3.93,5.75,Battu
49,07,57716,544,1305,59565,24926,84491,Mme Céline L'HUILLIER,EXG,810,0.96,1.4,Battu
49,07,57716,544,1305,59565,24926,84491,M. Régis CRESPIN,DSV,750,0.89,1.3,Battu
49,07,57716,544,1305,59565,24926,84491,Mme Valérie GORIOUX,REC,715,0.85,1.24,Battu
49,07,57716,544,1305,59565,24926,84491,M. Raphaël DE LA SALMONIERE,DVD,0,0,0,Battu
50,01,58778,328,929,60035,26692,86727,M. Philippe GOSSELIN,DVD,22513,25.96,38.3,Qualif
50,01,58778,328,929,60035,26692,86727,M. Franck SIMON,RN,19333,22.29,32.89,Qualif
50,01,58778,328,929,60035,26692,86727,M. Guillaume HEDOUIN,UG,10792,12.44,18.36,Battu
50,01,58778,328,929,60035,26692,86727,M. Michaël MASSON,ENS,4723,5.45,8.04,Battu
50,01,58778,328,929,60035,26692,86727,Mme Olivia LEWI,EXG,578,0.67,0.98,Battu
50,01,58778,328,929,60035,26692,86727,M. Laurent BESAGNY,REC,418,0.48,0.71,Battu
50,01,58778,328,929,60035,26692,86727,M. Baptiste RAJAUT,ECO,250,0.29,0.43,Battu
50,01,58778,328,929,60035,26692,86727,M. Jacques POISSON,DVD,171,0.2,0.29,Battu
50,02,66541,525,1193,68259,28521,96780,M. Bertrand SORRE,ENS,26555,27.44,39.91,Qualif
50,02,66541,525,1193,68259,28521,96780,Mme Marie-Françoise KURDZIEL,RN,21186,21.89,31.84,Qualif
50,02,66541,525,1193,68259,28521,96780,M. Patrick GRIMBERT,UG,11529,11.91,17.33,Battu
50,02,66541,525,1193,68259,28521,96780,Mme Julie BARENTON GUILLAS,DVD,5739,5.93,8.62,Battu
50,02,66541,525,1193,68259,28521,96780,Mme Mai TRAN,EXG,811,0.84,1.22,Battu
50,02,66541,525,1193,68259,28521,96780,M. Hervé RETAILLEAU,REC,721,0.74,1.08,Battu
50,03,75904,505,1454,77863,33235,111098,M. Pierre GIRY,UXD,25725,23.16,33.89,Qualif
50,03,75904,505,1454,77863,33235,111098,M. Stéphane TRAVERT,ENS,25232,22.71,33.24,Qualif
50,03,75904,505,1454,77863,33235,111098,Mme Gaëlle VEROVE,UG,15191,13.67,20.01,Qualif
50,03,75904,505,1454,77863,33235,111098,Mme Stéphanie MAUBÉ,DIV,6951,6.26,9.16,Battu
50,03,75904,505,1454,77863,33235,111098,M. Yohann QUESNEL,DSV,945,0.85,1.24,Battu
50,03,75904,505,1454,77863,33235,111098,M. Christian GUYOT,REC,842,0.76,1.11,Battu
50,03,75904,505,1454,77863,33235,111098,M. Mansour AYOUTI,EXG,629,0.57,0.83,Battu
50,03,75904,505,1454,77863,33235,111098,M. Aurélien VERLEYEN,ECO,389,0.35,0.51,Battu
50,04,58259,399,1082,59740,28923,88663,Mme Anna PIC,UG,19940,22.49,34.23,Qualif
50,04,58259,399,1082,59740,28923,88663,M. Nicolas CONQUER,UXD,17481,19.72,30.01,Qualif
50,04,58259,399,1082,59740,28923,88663,M. Yann LEPETIT,ENS,10417,11.75,17.88,Battu
50,04,58259,399,1082,59740,28923,88663,Mme Camille MARGUERITTE,DVD,8637,9.74,14.83,Battu
50,04,58259,399,1082,59740,28923,88663,M. Abdelkader BENRAMDANE,EXG,900,1.02,1.54,Battu
50,04,58259,399,1082,59740,28923,88663,M. Yann DA CRUZ-LEGELEUX,REC,884,1,1.52,Battu
51,01,47446,340,789,48575,26815,75390,M. Adrien MEXIS,DVD,17697,23.47,37.3,Qualif
51,01,47446,340,789,48575,26815,75390,M. Xavier ALBERTINI,ENS,16058,21.3,33.84,Qualif
51,01,47446,340,789,48575,26815,75390,Mme Evelyne BOURGOIN,UG,12835,17.02,27.05,Qualif
51,01,47446,340,789,48575,26815,75390,M. Vincent VARLET,EXG,856,1.14,1.8,Battu
51,02,48553,338,552,49443,25184,74627,Mme Anne-Sophie FRIGOUT,RN,17645,23.64,36.34,Qualif
51,02,48553,338,552,49443,25184,74627,Mme Laure MILLER,ENS,14756,19.77,30.39,Qualif
51,02,48553,338,552,49443,25184,74627,M. Stéphane PIROUELLE,UG,10560,14.15,21.75,Qualif
51,02,48553,338,552,49443,25184,74627,M. Stéphane LANG,DVD,3425,4.59,7.05,Battu
51,02,48553,338,552,49443,25184,74627,M. Ghislain WYSOCINSKI,ECO,1301,1.74,2.68,Battu
51,02,48553,338,552,49443,25184,74627,Mme Marie PACE,REC,446,0.6,0.92,Battu
51,02,48553,338,552,49443,25184,74627,M. Thomas ROSE,EXG,420,0.56,0.87,Battu
51,03,49936,575,1257,51768,26708,78476,M. Maxime MICHELET,UXD,21890,27.89,43.84,Qualif
51,03,49936,575,1257,51768,26708,78476,M. Eric GIRARDIN,ENS,15942,20.31,31.92,Qualif
51,03,49936,575,1257,51768,26708,78476,Mme Chantal BERTHÉLÉMY,UG,9397,11.97,18.82,Battu
51,03,49936,575,1257,51768,26708,78476,Mme Johanna JABBOUR,DSV,1219,1.55,2.44,Battu
51,03,49936,575,1257,51768,26708,78476,Mme Charlotte CORMERAIS,EXG,769,0.98,1.54,Battu
51,03,49936,575,1257,51768,26708,78476,M. Julien SENE,REC,719,0.92,1.44,Battu
51,04,49208,442,840,50490,27404,77894,M. Achille BISIAUX,RN,21045,27.02,42.77,Qualif
51,04,49208,442,840,50490,27404,77894,Mme Lise MAGNIER,ENS,15245,19.57,30.98,Qualif
51,04,49208,442,840,50490,27404,77894,M. Maxence LAURENT,UG,8845,11.36,17.97,Battu
51,04,49208,442,840,50490,27404,77894,M. Gabriel MICHEL,LR,3249,4.17,6.6,Battu
51,04,49208,442,840,50490,27404,77894,M. Laurent GOSSEAU,EXG,690,0.89,1.4,Battu
51,04,49208,442,840,50490,27404,77894,M. Marty DUCANDA,DIV,134,0.17,0.27,Battu
51,05,50981,374,616,51971,23631,75602,M. Thierry BESSON,RN,23954,31.68,46.99,Qualif
51,05,50981,374,616,51971,23631,75602,M. Charles DE COURSON,DVC,21751,28.77,42.66,Qualif
51,05,50981,374,616,51971,23631,75602,M. Gaël PADIOU,UG,4774,6.31,9.36,Battu
51,05,50981,374,616,51971,23631,75602,Mme Joëlle BASTIEN,EXG,502,0.66,0.98,Battu
52,01,44672,763,1159,46594,22577,69171,M. Christophe BENTZ,RN,21815,31.54,48.83,Qualif
52,01,44672,763,1159,46594,22577,69171,Mme Bérangère ABBA,ENS,12529,18.11,28.05,Qualif
52,01,44672,763,1159,46594,22577,69171,M. Benjamin LAMBERT,UG,9104,13.16,20.38,Qualif
52,01,44672,763,1159,46594,22577,69171,M. Sylvain DEMAY,EXG,869,1.26,1.95,Battu
52,01,44672,763,1159,46594,22577,69171,M. Baptiste GALLET,DIV,355,0.51,0.79,Battu
52,02,36976,426,670,38072,20971,59043,Mme Laurence ROBERT-DEHAULT,RN,21009,35.58,56.82,Elu
52,02,36976,426,670,38072,20971,59043,M. Nicolas LACROIX,DVD,10407,17.63,28.15,Battu
52,02,36976,426,670,38072,20971,59043,Mme Ingrid VIOT,UG,4876,8.26,13.19,Battu
52,02,36976,426,670,38072,20971,59043,M. Justin PRUM,EXG,684,1.16,1.85,Battu
53,01,49533,391,859,50783,23384,74167,M. Guillaume GAROT,UG,22483,30.31,45.39,Qualif
53,01,49533,391,859,50783,23384,74167,Mme Paule VEYRE DE SORAS,RN,14161,19.09,28.59,Qualif
53,01,49533,391,859,50783,23384,74167,M. Vincent SAULNIER,UDI,9957,13.43,20.1,Qualif
53,01,49533,391,859,50783,23384,74167,Mme Stéphanie HIBON ARTHUIS,DVD,2467,3.33,4.98,Battu
53,01,49533,391,859,50783,23384,74167,M. Fabrice ROMIER,EXG,465,0.63,0.94,Battu
53,02,53301,517,1161,54979,24780,79759,Mme Géraldine BANNIER,ENS,18746,23.5,35.17,Qualif
53,02,53301,517,1161,54979,24780,79759,M. Jean-Michel CADENAS,RN,16944,21.24,31.79,Qualif
53,02,53301,517,1161,54979,24780,79759,M. Grégory BOISSEAU,UG,12135,15.21,22.77,Qualif
53,02,53301,517,1161,54979,24780,79759,M. Pierre-Elie GUYON,DVD,4877,6.11,9.15,Battu
53,02,53301,517,1161,54979,24780,79759,M. Jean-Luc PLACE,EXG,390,0.49,0.73,Battu
53,02,53301,517,1161,54979,24780,79759,M. Patrice GRUDE,DIV,209,0.26,0.39,Battu
53,03,47848,470,867,49185,23470,72655,M. Yannick FAVENNEC,HOR,23294,32.06,48.68,Qualif
53,03,47848,470,867,49185,23470,72655,Mme Annie BELL,RN,14884,20.49,31.11,Qualif
53,03,47848,470,867,49185,23470,72655,Mme Stéphanie LEFOULON,UG,9176,12.63,19.18,Qualif
53,03,47848,470,867,49185,23470,72655,Mme Martine AMELIN,EXG,494,0.68,1.03,Battu
54,01,54722,357,798,55877,27392,83269,Mme Estelle MERCIER,UG,20645,24.79,37.73,Qualif
54,01,54722,357,798,55877,27392,83269,Mme Patricia MELET,RN,14719,17.68,26.9,Qualif
54,01,54722,357,798,55877,27392,83269,M. Philippe GUILLEMARD,ENS,14435,17.34,26.38,Qualif
54,01,54722,357,798,55877,27392,83269,M. Aurélien ARNOULD,LR,3518,4.22,6.43,Battu
54,01,54722,357,798,55877,27392,83269,Mme Christiane NIMSGERN,EXG,741,0.89,1.35,Battu
54,01,54722,357,798,55877,27392,83269,M. Massimo NESPOLO,DSV,664,0.8,1.21,Battu
54,02,45120,217,548,45885,22031,67916,M. Stéphane HABLOT,UG,18008,26.52,39.91,Qualif
54,02,45120,217,548,45885,22031,67916,M. Emmanuel LACRESSE,ENS,13869,20.42,30.74,Qualif
54,02,45120,217,548,45885,22031,67916,Mme Geneviève MAILLOT,RN,10131,14.92,22.45,Qualif
54,02,45120,217,548,45885,22031,67916,Mme Sloane FROMONT,LR,2325,3.42,5.15,Battu
54,02,45120,217,548,45885,22031,67916,Mme Lucy GEORGES,REC,422,0.62,0.94,Battu
54,02,45120,217,548,45885,22031,67916,Mme Odile DESTOMBES,EXG,365,0.54,0.81,Battu
54,03,45875,365,896,47136,33246,80382,M. Frédéric WEBER,RN,19938,24.8,43.46,Qualif
54,03,45875,365,896,47136,33246,80382,Mme Martine ETIENNE,UG,13068,16.26,28.49,Qualif
54,03,45875,365,896,47136,33246,80382,Mme Valérie MAURICE,ENS,8248,10.26,17.98,Battu
54,03,45875,365,896,47136,33246,80382,M. Mathieu SERVAGI,LR,3599,4.48,7.85,Battu
54,03,45875,365,896,47136,33246,80382,M. Xavier BOURY,EXG,1022,1.27,2.23,Battu
54,04,63194,506,1105,64805,31625,96430,Mme Dominique BILDE,RN,27618,28.64,43.7,Qualif
54,04,63194,506,1105,64805,31625,96430,M. Thibault BAZIN,LR,20984,21.76,33.21,Qualif
54,04,63194,506,1105,64805,31625,96430,Mme Barbara BERTOZZI-BIÉVELOT,UG,13009,13.49,20.59,Qualif
54,04,63194,506,1105,64805,31625,96430,Mme Geneviève HEILLIETTE,EXG,864,0.9,1.37,Battu
54,04,63194,506,1105,64805,31625,96430,Mme Valérie CANTIGET,REC,719,0.75,1.14,Battu
54,05,51565,452,1163,53180,25494,78674,M. Dominique POTIER,UG,22415,28.49,43.47,Qualif
54,05,51565,452,1163,53180,25494,78674,M. Louis-Joseph PECHER,EXD,15704,19.96,30.45,Qualif
54,05,51565,452,1163,53180,25494,78674,M. Quentin VINOT,LR,7220,9.18,14,Battu
54,05,51565,452,1163,53180,25494,78674,M. Pierre-Nicolas NUPS,EXD,5190,6.6,10.06,Battu
54,05,51565,452,1163,53180,25494,78674,Mme Miriam AUBERT,EXG,792,1.01,1.54,Battu
54,05,51565,452,1163,53180,25494,78674,M. Edouard MATHIEU,DIV,244,0.31,0.47,Battu
54,06,54168,442,1090,55700,31866,87566,M. Anthony BOULOGNE,RN,24121,27.55,44.53,Qualif
54,06,54168,442,1090,55700,31866,87566,Mme Caroline FIAT,UG,14479,16.53,26.73,Qualif
54,06,54168,442,1090,55700,31866,87566,M. Ergün TOPARSLAN,ENS,8353,9.54,15.42,Battu
54,06,54168,442,1090,55700,31866,87566,M. Jordan SIMON,LR,4700,5.37,8.68,Battu
54,06,54168,442,1090,55700,31866,87566,M. Richard NOWAK,ECO,1133,1.29,2.09,Battu
54,06,54168,442,1090,55700,31866,87566,M. Dominique BARBIN,EXG,718,0.82,1.33,Battu
54,06,54168,442,1090,55700,31866,87566,Mme Sonia THIRION,DSV,664,0.76,1.23,Battu
55,01,49384,630,932,50946,24016,74962,M. Maxime AMBLARD,RN,23680,31.59,47.95,Qualif
55,01,49384,630,932,50946,24016,74962,M. Bertrand PANCHER,DVD,16901,22.55,34.22,Qualif
55,01,49384,630,932,50946,24016,74962,M. Olivier GUCKERT,UG,7066,9.43,14.31,Battu
55,01,49384,630,932,50946,24016,74962,Mme Sylvie MARIAGE,DSV,708,0.94,1.43,Battu
55,01,49384,630,932,50946,24016,74962,M. Grégoire MOUTAUX,DVD,548,0.73,1.11,Battu
55,01,49384,630,932,50946,24016,74962,M. Blaise TYMEN,EXG,481,0.64,0.97,Battu
55,02,37551,357,691,38599,20631,59230,Mme Florence GOULET,RN,19011,32.1,50.63,Elu
55,02,37551,357,691,38599,20631,59230,M. Jerome DUMONT,DVD,11976,20.22,31.89,Battu
55,02,37551,357,691,38599,20631,59230,M. Johan LAFLOTTE,UG,5391,9.1,14.36,Battu
55,02,37551,357,691,38599,20631,59230,Mme Valentine LAFUE,ECO,742,1.25,1.98,Battu
55,02,37551,357,691,38599,20631,59230,M. Pierre NORDEMANN,EXG,431,0.73,1.15,Battu
56,01,84561,409,1258,86228,29345,115573,Mme Anne LE HÉNANFF,ENS,35627,30.83,42.13,Qualif
56,01,84561,409,1258,86228,29345,115573,Mme Anne GALLO,UG,23884,20.67,28.24,Qualif
56,01,84561,409,1258,86228,29345,115573,M. Joseph MARTIN,RN,21454,18.56,25.37,Qualif
56,01,84561,409,1258,86228,29345,115573,M. Yann LE BARAILLEC,DVG,1898,1.64,2.24,Battu
56,01,84561,409,1258,86228,29345,115573,M. Ronan LE SANT,REG,1084,0.94,1.28,Battu
56,01,84561,409,1258,86228,29345,115573,M. Marc PESCHANSKI,EXG,432,0.37,0.51,Battu
56,01,84561,409,1258,86228,29345,115573,Mme Alice VASSEUR,DIV,182,0.16,0.22,Battu
56,02,82978,577,1387,84942,28784,113726,M. Jimmy PAHUN,ENS,26667,23.45,32.14,Qualif
56,02,82978,577,1387,84942,28784,113726,M. Florent DE KERSAUSON,RN,24920,21.91,30.03,Qualif
56,02,82978,577,1387,84942,28784,113726,Mme Jade BENIGUEL,UG,21405,18.82,25.8,Qualif
56,02,82978,577,1387,84942,28784,113726,M. Pierre CLAVREUIL,DVD,7472,6.57,9,Battu
56,02,82978,577,1387,84942,28784,113726,M. Maëlig TRÉDAN,REG,1615,1.42,1.95,Battu
56,02,82978,577,1387,84942,28784,113726,M. Yves CHEÈRE,EXG,899,0.79,1.08,Battu
56,03,68573,594,1343,70510,27644,98154,M. Antoine OLIVIERO,RN,24584,25.05,35.85,Qualif
56,03,68573,594,1343,70510,27644,98154,Mme Nicole LE PEIH,ENS,18222,18.56,26.57,Qualif
56,03,68573,594,1343,70510,27644,98154,Mme Marie Madeleine DORÉ-LUCAS,UG,13999,14.26,20.41,Qualif
56,03,68573,594,1343,70510,27644,98154,Mme Soizic PERRAULT,DVD,8340,8.5,12.16,Battu
56,03,68573,594,1343,70510,27644,98154,Mme Jocelyne DEVRIENDT,REG,1078,1.1,1.57,Battu
56,03,68573,594,1343,70510,27644,98154,M. Lionel ÉPAILLARD,ECO,943,0.96,1.38,Battu
56,03,68573,594,1343,70510,27644,98154,Mme Julie CUCINIELLO,DSV,719,0.73,1.05,Battu
56,03,68573,594,1343,70510,27644,98154,Mme Julie LEPERT,EXG,688,0.7,1,Battu
56,04,80659,337,1013,82009,31619,113628,M. Paul MOLAC,REG,28912,25.44,35.84,Qualif
56,04,80659,337,1013,82009,31619,113628,Mme Katel LE CUILLIER,RN,25414,22.37,31.51,Qualif
56,04,80659,337,1013,82009,31619,113628,Mme Rozenn GUEGAN,ENS,12487,10.99,15.48,Battu
56,04,80659,337,1013,82009,31619,113628,Mme Lhea LE FLECHER,UG,11809,10.39,14.64,Battu
56,04,80659,337,1013,82009,31619,113628,M. Bernard HUET,DSV,920,0.81,1.14,Battu
56,04,80659,337,1013,82009,31619,113628,M. Khaled MAMAR,ECO,602,0.53,0.75,Battu
56,04,80659,337,1013,82009,31619,113628,M. Patrice CRUNIL,EXG,515,0.45,0.64,Battu
56,05,55145,314,1125,56584,24236,80820,M. Damien GIRARD,UG,19612,24.27,35.56,Qualif
56,05,55145,314,1125,56584,24236,80820,Mme Lysiane MÉTAYER,ENS,19081,23.61,34.6,Qualif
56,05,55145,314,1125,56584,24236,80820,Mme Aurélie LE GOFF,RN,15386,19.04,27.9,Qualif
56,05,55145,314,1125,56584,24236,80820,Mme Blandine PIERRON,EXG,1066,1.32,1.93,Battu
56,06,65525,575,1404,67504,26326,93830,Mme Nathalie GUIHOT-VIEIRA,RN,22728,24.22,34.69,Qualif
56,06,65525,575,1404,67504,26326,93830,M. Jean-Michel JACQUES,ENS,21675,23.1,33.08,Qualif
56,06,65525,575,1404,67504,26326,93830,M. Jean-Michel BAUDRY,UG,15561,16.58,23.75,Qualif
56,06,65525,575,1404,67504,26326,93830,M. Daniel BARACH,DVD,3513,3.74,5.36,Battu
56,06,65525,575,1404,67504,26326,93830,Mme Kelig LAGREE,EXG,1213,1.29,1.85,Battu
56,06,65525,575,1404,67504,26326,93830,M. Valère CHARLERY,DSV,835,0.89,1.27,Battu
57,01,56689,490,1367,58546,35384,93930,M. Grégoire LALOUX,RN,22570,24.03,39.81,Qualif
57,01,56689,490,1367,58546,35384,93930,M. Belkhir BELHADDAD,ENS,15640,16.65,27.59,Qualif
57,01,56689,490,1367,58546,35384,93930,M. Vincent FELIX,UG,14793,15.75,26.1,Qualif
57,01,56689,490,1367,58546,35384,93930,M. Stephen DUSO-BAUDUIN,DIV,1094,1.16,1.93,Battu
57,01,56689,490,1367,58546,35384,93930,M. Jean-François JACQUES,DSV,1027,1.09,1.81,Battu
57,01,56689,490,1367,58546,35384,93930,M. Didier GEORGET,EXG,745,0.79,1.31,Battu
57,01,56689,490,1367,58546,35384,93930,M. Américo Jonas COSTA,DIV,618,0.66,1.09,Battu
57,01,56689,490,1367,58546,35384,93930,Mme Célia LEJAL,EXG,202,0.22,0.36,Battu
57,02,48963,456,1022,50441,26337,76778,Mme Marie-Claude VOINCON,RN,18352,23.9,37.48,Qualif
57,02,48963,456,1022,50441,26337,76778,M. Ludovic MENDES,ENS,14795,19.27,30.22,Qualif
57,02,48963,456,1022,50441,26337,76778,M. Victorien NICOLAS,UG,13028,16.97,26.61,Qualif
57,02,48963,456,1022,50441,26337,76778,M. Laurent PARISSE,DIV,1477,1.92,3.02,Battu
57,02,48963,456,1022,50441,26337,76778,Mme Aurélie CONTAL,REG,741,0.97,1.51,Battu
57,02,48963,456,1022,50441,26337,76778,M. Mario RINALDI,EXG,461,0.6,0.94,Battu
57,02,48963,456,1022,50441,26337,76778,Mme Gisèle TATY BOUANGA,DIV,109,0.14,0.22,Battu
57,03,47986,366,991,49343,26714,76057,M. Victor CHOMARD,RN,16948,22.28,35.32,Qualif
57,03,47986,366,991,49343,26714,76057,Mme Nathalie COLIN-OESTERLÉ,UDI,16631,21.87,34.66,Qualif
57,03,47986,366,991,49343,26714,76057,Mme Charlotte LEDUC,UG,13565,17.84,28.27,Qualif
57,03,47986,366,991,49343,26714,76057,M. Etienne HODARA,EXG,699,0.92,1.46,Battu
57,03,47986,366,991,49343,26714,76057,M. Gaël DIAFERIA,EXG,143,0.19,0.3,Battu
57,04,52190,400,703,53293,27484,80777,Mme Océane SIMON,RN,22265,27.56,42.66,Qualif
57,04,52190,400,703,53293,27484,80777,M. Fabien DI FILIPPO,LR,18659,23.1,35.75,Qualif
57,04,52190,400,703,53293,27484,80777,Mme Helene GIRARDOT,UG,6156,7.62,11.8,Battu
57,04,52190,400,703,53293,27484,80777,Mme Emilie CRENNER,ENS,4191,5.19,8.03,Battu
57,04,52190,400,703,53293,27484,80777,M. Jean-Philippe BOTT,REC,464,0.57,0.89,Battu
57,04,52190,400,703,53293,27484,80777,M. Marc BAUD-BERTIER,EXG,438,0.54,0.84,Battu
57,04,52190,400,703,53293,27484,80777,Mme Léna DECKER,REG,17,0.02,0.03,Battu
57,05,43950,405,763,45118,26977,72095,M. Pascal JENFT,RN,20884,28.97,47.52,Qualif
57,05,43950,405,763,45118,26977,72095,M. Vincent SEITLINGER,LR,15045,20.87,34.23,Qualif
57,05,43950,405,763,45118,26977,72095,Mme Lisa LAHORE,UG,5439,7.54,12.38,Battu
57,05,43950,405,763,45118,26977,72095,M. Denis LIEB,REG,1128,1.56,2.57,Battu
57,05,43950,405,763,45118,26977,72095,M. Hervé HOCQUET,DSV,552,0.77,1.26,Battu
57,05,43950,405,763,45118,26977,72095,M. Gilles SEBASTIAN,EXG,453,0.63,1.03,Battu
57,05,43950,405,763,45118,26977,72095,M. Stéphane MARCHAND,REC,449,0.62,1.02,Battu
57,06,36493,246,666,37405,28988,66393,M. Kévin PFEFFER,RN,18575,27.98,50.9,Elu
57,06,36493,246,666,37405,28988,66393,M. Alexandre CASSARO,LR,7746,11.67,21.23,Battu
57,06,36493,246,666,37405,28988,66393,Mme Claire BLADT,UG,7740,11.66,21.21,Battu
57,06,36493,246,666,37405,28988,66393,M. Dominique FEISS,DVD,1348,2.03,3.69,Battu
57,06,36493,246,666,37405,28988,66393,Mme Lola LEGRAND,EXG,618,0.93,1.69,Battu
57,06,36493,246,666,37405,28988,66393,M. Olivier MUNCH,DVG,466,0.7,1.28,Battu
57,07,53498,412,1242,55152,34093,89245,M. Alexandre LOUBET,RN,28528,31.97,53.33,Elu
57,07,53498,412,1242,55152,34093,89245,M. Luc MULLER,UG,9913,11.11,18.53,Battu
57,07,53498,412,1242,55152,34093,89245,Mme Yasmine SELMANI,ENS,9644,10.81,18.03,Battu
57,07,53498,412,1242,55152,34093,89245,M. André WOJCIECHOWSKI,DVD,4403,4.93,8.23,Battu
57,07,53498,412,1242,55152,34093,89245,Mme Diane BOUSSET,EXG,931,1.04,1.74,Battu
57,07,53498,412,1242,55152,34093,89245,M. Younès BOUCETTA,DIV,79,0.09,0.15,Battu
57,08,50813,401,1112,52326,39048,91374,M. Laurent JACOBELLI,RN,23558,25.78,46.36,Qualif
57,08,50813,401,1112,52326,39048,91374,Mme Céline LEGER,UG,14724,16.11,28.98,Qualif
57,08,50813,401,1112,52326,39048,91374,M. Samuel ZONATO,ENS,7986,8.74,15.72,Battu
57,08,50813,401,1112,52326,39048,91374,Mme Raphaëlle ROSA,LR,3296,3.61,6.49,Battu
57,08,50813,401,1112,52326,39048,91374,Mme Annick JOLIVET,EXG,1249,1.37,2.46,Battu
57,09,63949,460,1308,65717,34994,100711,M. Baptiste PHILIPPO,RN,24483,24.31,38.29,Qualif
57,09,63949,460,1308,65717,34994,100711,Mme Isabelle RAUCH,ENS,22460,22.3,35.12,Qualif
57,09,63949,460,1308,65717,34994,100711,Mme Brigitte VAÎSSE,UG,14607,14.5,22.84,Qualif
57,09,63949,460,1308,65717,34994,100711,M. Florent HAMMERSCHMITT,REC,1181,1.17,1.85,Battu
57,09,63949,460,1308,65717,34994,100711,M. Guy MAURHOFER,EXG,805,0.8,1.26,Battu
57,09,63949,460,1308,65717,34994,100711,M. Laurent KOPP,DIV,413,0.41,0.65,Battu
58,01,46238,432,1217,47887,25963,73850,M. Charles-Henri GALLOIS,RN,18870,25.55,40.81,Qualif
58,01,46238,432,1217,47887,25963,73850,Mme Perrine GOULET,ENS,13593,18.41,29.4,Qualif
58,01,46238,432,1217,47887,25963,73850,M. Brice LARÈPE,UG,9856,13.35,21.32,Qualif
58,01,46238,432,1217,47887,25963,73850,M. Baptiste DUBOST,LR,2482,3.36,5.37,Battu
58,01,46238,432,1217,47887,25963,73850,Mme Geneviève LEMOINE,EXG,809,1.1,1.75,Battu
58,01,46238,432,1217,47887,25963,73850,Mme Chantal VARELA,DSV,628,0.85,1.36,Battu
58,02,52382,819,1055,54256,24509,78765,M. Julien GUIBERT,RN,23480,29.81,44.82,Qualif
58,02,52382,819,1055,54256,24509,78765,M. Christian PAUL,UG,13788,17.51,26.32,Qualif
58,02,52382,819,1055,54256,24509,78765,Mme Sandra GERMAIN,ENS,10708,13.59,20.44,Qualif
58,02,52382,819,1055,54256,24509,78765,M. Marc Alexandre VINCENT,LR,2757,3.5,5.26,Battu
58,02,52382,819,1055,54256,24509,78765,M. Dominique DUPUIS,EXG,839,1.07,1.6,Battu
58,02,52382,819,1055,54256,24509,78765,Mme Aurore MUNOZ,DSV,801,1.02,1.53,Battu
58,02,52382,819,1055,54256,24509,78765,Mme Justine GUYOT,DVG,9,0.01,0.02,Battu
59,01,40268,227,448,40943,20729,61672,M. Aurélien LE COQ,UG,17800,28.86,44.2,Qualif
59,01,40268,227,448,40943,20729,61672,Mme Carole LECLERCQ,RN,7298,11.83,18.12,Qualif
59,01,40268,227,448,40943,20729,61672,Mme Vanessa DUHAMEL,ENS,7055,11.44,17.52,Battu
59,01,40268,227,448,40943,20729,61672,Mme Amy BAH,DVG,3551,5.76,8.82,Battu
59,01,40268,227,448,40943,20729,61672,M. Brice LAURET,DVD,1951,3.16,4.85,Battu
59,01,40268,227,448,40943,20729,61672,M. Maxime LEGRAND,DVG,1169,1.9,2.9,Battu
59,01,40268,227,448,40943,20729,61672,Mme Allison MARINHO,DVD,610,0.99,1.51,Battu
59,01,40268,227,448,40943,20729,61672,M. Audric ALEXANDRE,DIV,345,0.56,0.86,Battu
59,01,40268,227,448,40943,20729,61672,M. Pierre MADELAIN,EXG,217,0.35,0.54,Battu
59,01,40268,227,448,40943,20729,61672,M. Michel LAURENÇOT,DVG,199,0.32,0.49,Battu
59,01,40268,227,448,40943,20729,61672,Mme Verena PRIEM,REG,58,0.09,0.14,Battu
59,01,40268,227,448,40943,20729,61672,M. Frédéric CHAOUAT,DIV,14,0.02,0.03,Battu
59,01,40268,227,448,40943,20729,61672,Mme Adel BOUSALHAM,DVG,1,0,0,Battu
59,01,40268,227,448,40943,20729,61672,Mme Line MARAGE,EXG,0,0,0,Battu
59,02,55993,404,841,57238,30117,87355,M. Ugo BERNALICIS,UG,26491,30.33,47.31,Qualif
59,02,55993,404,841,57238,30117,87355,M. Philippe GUÉRARD,RN,12256,14.03,21.89,Qualif
59,02,55993,404,841,57238,30117,87355,Mme Violette SALANON,ENS,11630,13.31,20.77,Qualif
59,02,55993,404,841,57238,30117,87355,Mme Caroline BOISARD-VANNIER,LR,4378,5.01,7.82,Battu
59,02,55993,404,841,57238,30117,87355,Mme Pascale ROUGÉE,EXG,645,0.74,1.15,Battu
59,02,55993,404,841,57238,30117,87355,Mme Claire GUENON,DIV,385,0.44,0.69,Battu
59,02,55993,404,841,57238,30117,87355,M. Etienne TESTART,EXG,208,0.24,0.37,Battu
59,03,52876,468,1278,54622,36998,91620,Mme Sandra DELANNOY,RN,26874,29.33,50.82,Elu
59,03,52876,468,1278,54622,36998,91620,M. Benjamin SAINT-HUILE,DVG,23429,25.57,44.31,Battu
59,03,52876,468,1278,54622,36998,91620,Mme Marie-Claude RONDEAUX,EXG,1697,1.85,3.21,Battu
59,03,52876,468,1278,54622,36998,91620,M. Louis MAHIEU,REC,876,0.96,1.66,Battu
59,04,68634,403,967,70004,31829,101833,Mme Brigitte LISO,ENS,21494,21.11,31.32,Qualif
59,04,68634,403,967,70004,31829,101833,Mme Charlotte BRUN,UG,20301,19.94,29.58,Qualif
59,04,68634,403,967,70004,31829,101833,Mme Anne MORAND,RN,17832,17.51,25.98,Qualif
59,04,68634,403,967,70004,31829,101833,M. Sébastien LEBLANC,LR,6461,6.34,9.41,Battu
59,04,68634,403,967,70004,31829,101833,M. Nicolas LE NEINDRE,DVD,1330,1.31,1.94,Battu
59,04,68634,403,967,70004,31829,101833,Mme Fatima ABDELLAOUI,EXG,539,0.53,0.79,Battu
59,04,68634,403,967,70004,31829,101833,M. Patrick JARDIN,REC,533,0.52,0.78,Battu
59,04,68634,403,967,70004,31829,101833,M. Franck BOYAVAL,DIV,144,0.14,0.21,Battu
59,04,68634,403,967,70004,31829,101833,M. Damien SCALI,EXG,0,0,0,Battu
59,05,68394,475,1457,70326,31957,102283,M. Victor CATTEAU,RN,27411,26.8,40.08,Qualif
59,05,68394,475,1457,70326,31957,102283,M. Sébastien HUYGHE,DVD,23510,22.99,34.37,Qualif
59,05,68394,475,1457,70326,31957,102283,Mme Ophélie DELNESTE,UG,16591,16.22,24.26,Qualif
59,05,68394,475,1457,70326,31957,102283,M. Raymond COVAIN,EXG,858,0.84,1.25,Battu
59,05,68394,475,1457,70326,31957,102283,Mme Chloé OLIVEREAU,EXG,24,0.02,0.04,Battu
59,06,67807,373,1236,69416,25642,95058,Mme Charlotte PARMENTIER-LECOCQ,ENS,25831,27.17,38.09,Qualif
59,06,67807,373,1236,69416,25642,95058,Mme Marie Hélène QUATREBOEUFS,UXD,23781,25.02,35.07,Qualif
59,06,67807,373,1236,69416,25642,95058,Mme Célia PEREIRA,UG,13243,13.93,19.53,Qualif
59,06,67807,373,1236,69416,25642,95058,M. Jimi EROTICO,LR,4265,4.49,6.29,Battu
59,06,67807,373,1236,69416,25642,95058,M. Frédéric BARREZ,EXG,687,0.72,1.01,Battu
59,07,46764,341,760,47865,25579,73444,Mme Félicie GERARD,HOR,17168,23.38,36.71,Qualif
59,07,46764,341,760,47865,25579,73444,Mme Karima CHOUIA,UG,15053,20.5,32.19,Qualif
59,07,46764,341,760,47865,25579,73444,Mme Céline SAYAH,RN,13163,17.92,28.15,Qualif
59,07,46764,341,760,47865,25579,73444,M. Jean-Sébastien Paul Louis WILLEM,REC,763,1.04,1.63,Battu
59,07,46764,341,760,47865,25579,73444,M. Nicolas SCHUURMAN,EXG,617,0.84,1.32,Battu
59,08,35885,345,745,36975,31958,68933,M. David GUIRAUD,UG,17405,25.25,48.5,Qualif
59,08,35885,345,745,36975,31958,68933,M. Ethan LEYS,RN,11051,16.03,30.8,Qualif
59,08,35885,345,745,36975,31958,68933,M. Tarik MEKKI,DVC,5766,8.36,16.07,Battu
59,08,35885,345,745,36975,31958,68933,M. Maël CAMERLYNCK,DSV,1011,1.47,2.82,Battu
59,08,35885,345,745,36975,31958,68933,Mme Françoise DELBARRE,EXG,652,0.95,1.82,Battu
59,09,60629,299,656,61584,30461,92045,Mme Violette SPILLEBOUT,ENS,20620,22.4,34.01,Qualif
59,09,60629,299,656,61584,30461,92045,Mme Odile VIDAL-SAGNIER,UG,18869,20.5,31.12,Qualif
59,09,60629,299,656,61584,30461,92045,Mme Christine LANDRU,RN,12533,13.62,20.67,Qualif
59,09,60629,299,656,61584,30461,92045,Mme Alice POGAM,LR,5572,6.05,9.19,Battu
59,09,60629,299,656,61584,30461,92045,M. Charles DELAVENNE,DVD,1832,1.99,3.02,Battu
59,09,60629,299,656,61584,30461,92045,Mme Valérie TALPAERT,REC,561,0.61,0.93,Battu
59,09,60629,299,656,61584,30461,92045,Mme Chantal SARAZIN,EXG,477,0.52,0.79,Battu
59,09,60629,299,656,61584,30461,92045,M. Frédéric GRUZON,DIV,161,0.17,0.27,Battu
59,09,60629,299,656,61584,30461,92045,M. Mathias DHELIN,EXG,4,0,0.01,Battu
59,10,48601,276,814,49691,33501,83192,M. Gérald DARMANIN,ENS,17512,21.05,36.03,Qualif
59,10,48601,276,814,49691,33501,83192,M. Bastien VERBRUGGHE,RN,16675,20.04,34.31,Qualif
59,10,48601,276,814,49691,33501,83192,M. Leslie MORTREUX,UG,12065,14.5,24.82,Qualif
59,10,48601,276,814,49691,33501,83192,M. Jérôme GARCIA,DVD,1447,1.74,2.98,Battu
59,10,48601,276,814,49691,33501,83192,M. Christophe CHARLON,EXG,535,0.64,1.1,Battu
59,10,48601,276,814,49691,33501,83192,M. Gustave VIGUIE-DESPLACES,REC,249,0.3,0.51,Battu
59,10,48601,276,814,49691,33501,83192,M. Marcellin BRAZON,DVD,118,0.14,0.24,Battu
59,11,59263,504,1047,60814,32377,93191,M. Roger VICOT,UG,22809,24.48,38.49,Qualif
59,11,59263,504,1047,60814,32377,93191,M. Maxime MOULIN,RN,18650,20.01,31.47,Qualif
59,11,59263,504,1047,60814,32377,93191,Mme Ingrid BRULANT-FORTIN,ENS,16559,17.77,27.94,Qualif
59,11,59263,504,1047,60814,32377,93191,Mme Carole BAILLEUL,EXG,778,0.83,1.31,Battu
59,11,59263,504,1047,60814,32377,93191,M. Jonathan WILSON,EXG,450,0.48,0.76,Battu
59,11,59263,504,1047,60814,32377,93191,M. Robin COUPIGNY,EXG,17,0.02,0.03,Battu
59,12,57664,510,1263,59437,33633,93070,M. Michael TAVERNE,RN,31567,33.92,54.74,Elu
59,12,57664,510,1263,59437,33633,93070,M. Sébastien SEGUIN,DVD,12279,13.19,21.29,Battu
59,12,57664,510,1263,59437,33633,93070,M. Bernard BAUDOUX,UG,11992,12.88,20.8,Battu
59,12,57664,510,1263,59437,33633,93070,Mme Isabelle PREVOST,REC,932,1,1.62,Battu
59,12,57664,510,1263,59437,33633,93070,M. Laurent LEHRHAUPT,EXG,894,0.96,1.55,Battu
59,13,49776,392,1173,51341,34704,86045,M. Maxence ACCART,RN,21662,25.18,43.52,Qualif
59,13,49776,392,1173,51341,34704,86045,M. Julien GOKEL,DIV,16026,18.63,32.2,Qualif
59,13,49776,392,1173,51341,34704,86045,M. Damien LACROIX,UG,10913,12.68,21.92,Qualif
59,13,49776,392,1173,51341,34704,86045,M. Clément BÉZINE,EXG,1175,1.37,2.36,Battu
59,14,65122,514,1328,66964,32485,99449,M. Jean-Baptiste GARDES,UXD,30194,30.36,46.37,Qualif
59,14,65122,514,1328,66964,32485,99449,M. Paul CHRISTOPHE,DVD,23928,24.06,36.74,Qualif
59,14,65122,514,1328,66964,32485,99449,Mme Philippine HEYMAN,UG,8876,8.93,13.63,Battu
59,14,65122,514,1328,66964,32485,99449,Mme Sandrine DESRAYAUD,EXG,1091,1.1,1.68,Battu
59,14,65122,514,1328,66964,32485,99449,Mme Anne-Lise PERCHE,DSV,1033,1.04,1.59,Battu
59,15,65031,647,1214,66892,30709,97601,M. Pierrick BERTELOOT,RN,29894,30.63,45.97,Qualif
59,15,65031,647,1214,66892,30709,97601,M. Jean-Pierre BATAILLE,DVD,22206,22.75,34.15,Qualif
59,15,65031,647,1214,66892,30709,97601,Mme Émilie DUCOURANT,UG,11853,12.14,18.23,Battu
59,15,65031,647,1214,66892,30709,97601,M. Benjamin DUBIEZ,EXG,1078,1.1,1.66,Battu
59,16,50087,416,1091,51594,32447,84041,M. Matthieu MARCHIO,RN,26608,31.66,53.12,Elu
59,16,50087,416,1091,51594,32447,84041,M. Alain BRUNEEL,UG,14199,16.9,28.35,Battu
59,16,50087,416,1091,51594,32447,84041,M. François CRESTA,ENS,8135,9.68,16.24,Battu
59,16,50087,416,1091,51594,32447,84041,M. Éric PECQUEUR,EXG,1145,1.36,2.29,Battu
59,17,45495,370,860,46725,27150,73875,M. Thierry TESSON,RN,21803,29.51,47.92,Qualif
59,17,45495,370,860,46725,27150,73875,M. Frédéric CHÉREAU,UG,13575,18.38,29.84,Qualif
59,17,45495,370,860,46725,27150,73875,M. Guillaume HONORÉ,ENS,5739,7.77,12.61,Battu
59,17,45495,370,860,46725,27150,73875,M. Loick BROUAZIN,LR,3627,4.91,7.97,Battu
59,17,45495,370,860,46725,27150,73875,M. Cédric FLUCKIGER,EXG,751,1.02,1.65,Battu
59,18,55998,415,998,57411,33410,90821,M. Alexandre DUFOSSET,RN,29404,32.38,52.51,Elu
59,18,55998,415,998,57411,33410,90821,M. Nicolas SIEGLER,DVD,18434,20.3,32.92,Battu
59,18,55998,415,998,57411,33410,90821,M. Benoît MARECHAL,UG,7230,7.96,12.91,Battu
59,18,55998,415,998,57411,33410,90821,Mme Nadine REYNAERT,EXG,930,1.02,1.66,Battu
59,19,47313,449,989,48751,32139,80890,M. Sébastien CHENU,RN,27592,34.11,58.32,Elu
59,19,47313,449,989,48751,32139,80890,M. Cédric BRUN,UG,10337,12.78,21.85,Battu
59,19,47313,449,989,48751,32139,80890,M. Franck WATELET,ENS,7136,8.82,15.08,Battu
59,19,47313,449,989,48751,32139,80890,M. Djemi DRICI,DIV,1150,1.42,2.43,Battu
59,19,47313,449,989,48751,32139,80890,Mme Cécile BOURLET,EXG,1098,1.36,2.32,Battu
59,20,47419,335,757,48511,33679,82190,M. Guillaume FLORQUIN,RN,23852,29.02,50.3,Elu
59,20,47419,335,757,48511,33679,82190,M. Fabien ROUSSEL,UG,14791,18,31.19,Battu
59,20,47419,335,757,48511,33679,82190,M. Pierre-Luc VERVANDIER,ENS,5010,6.1,10.57,Battu
59,20,47419,335,757,48511,33679,82190,Mme Élisabeth GONDY,UDI,3087,3.76,6.51,Battu
59,20,47419,335,757,48511,33679,82190,M. Dimitri MOZDZIERZ,EXG,679,0.83,1.43,Battu
59,21,48922,357,884,50163,30997,81160,Mme Laurence BARA,RN,21337,26.29,43.61,Qualif
59,21,48922,357,884,50163,30997,81160,Mme Valérie LÉTARD,UDI,14280,17.59,29.19,Qualif
59,21,48922,357,884,50163,30997,81160,M. Pierrick COLPIN,UG,11290,13.91,23.08,Qualif
59,21,48922,357,884,50163,30997,81160,Mme Édith DUQUESNOY,EXG,726,0.89,1.48,Battu
59,21,48922,357,884,50163,30997,81160,M. Laurent LASSELIN,DVD,709,0.87,1.45,Battu
59,21,48922,357,884,50163,30997,81160,Mme Séverine DUMINY,REC,580,0.71,1.19,Battu
60,01,53298,389,774,54461,28797,83258,Mme Claire MARAIS-BEUIL,RN,24621,29.57,46.19,Qualif
60,01,53298,389,774,54461,28797,83258,M. Victor HABERT-DASSAULT,LR,13049,15.67,24.48,Qualif
60,01,53298,389,774,54461,28797,83258,Mme Roxane LUNDY,UG,9402,11.29,17.64,Battu
60,01,53298,389,774,54461,28797,83258,M. Matys GUTIERREZ,ENS,4062,4.88,7.62,Battu
60,01,53298,389,774,54461,28797,83258,Mme Axelle LATRASSE,ECO,749,0.9,1.41,Battu
60,01,53298,389,774,54461,28797,83258,M. Souhail AOUAD,DVC,728,0.87,1.37,Battu
60,01,53298,389,774,54461,28797,83258,M. Jean-Philippe FRUITIER,EXG,348,0.42,0.65,Battu
60,01,53298,389,774,54461,28797,83258,M. Norbert DEPRESLES,REC,339,0.41,0.64,Battu
60,02,57933,503,1388,59824,29481,89305,M. Philippe BALLARD,RN,30823,34.51,53.2,Elu
60,02,57933,503,1388,59824,29481,89305,M. Ludovic CASTANIÉ,LR,12339,13.82,21.3,Battu
60,02,57933,503,1388,59824,29481,89305,Mme Marianne SECK,UG,10772,12.06,18.59,Battu
60,02,57933,503,1388,59824,29481,89305,M. Mohamed EL AIYATE,ECO,2144,2.4,3.7,Battu
60,02,57933,503,1388,59824,29481,89305,M. Pierre DELARBOULAS,REC,1225,1.37,2.11,Battu
60,02,57933,503,1388,59824,29481,89305,Mme Renée POTCHTOVIK,EXG,630,0.71,1.09,Battu
60,03,45218,332,902,46452,28043,74495,M. Alexandre SABATOU,RN,19487,26.16,43.1,Qualif
60,03,45218,332,902,46452,28043,74495,M. Amadou KA,UG,14149,18.99,31.29,Qualif
60,03,45218,332,902,46452,28043,74495,M. Pascal BOIS,ENS,8556,11.49,18.92,Battu
60,03,45218,332,902,46452,28043,74495,Mme Marie FERREIRA,UDI,1931,2.59,4.27,Battu
60,03,45218,332,902,46452,28043,74495,Mme Nadège LEGRIS,DIV,573,0.77,1.27,Battu
60,03,45218,332,902,46452,28043,74495,M. Roland SZPIRKO,EXG,522,0.7,1.15,Battu
60,04,62378,385,955,63718,30465,94183,M. Mathieu GRIMPRET,RN,25093,26.64,40.23,Qualif
60,04,62378,385,955,63718,30465,94183,M. Eric WOERTH,ENS,18646,19.8,29.89,Qualif
60,04,62378,385,955,63718,30465,94183,M. Mohamed ASSAMTI,UG,10644,11.3,17.06,Battu
60,04,62378,385,955,63718,30465,94183,M. Jean LEFEVRE,LR,3942,4.19,6.32,Battu
60,04,62378,385,955,63718,30465,94183,Mme Sophie REYNAL,DVC,2157,2.29,3.46,Battu
60,04,62378,385,955,63718,30465,94183,M. Jean-Claude CASAS,REC,772,0.82,1.24,Battu
60,04,62378,385,955,63718,30465,94183,Mme Caroline DASINI,EXG,422,0.45,0.68,Battu
60,04,62378,385,955,63718,30465,94183,M. Noël NGABISSIO,ECO,422,0.45,0.68,Battu
60,04,62378,385,955,63718,30465,94183,M. Augusto FERNANDES,DSV,280,0.3,0.45,Battu
60,05,47611,299,704,48614,25031,73645,M. Frédéric Pierre VOS,RN,20070,27.25,42.15,Qualif
60,05,47611,299,704,48614,25031,73645,M. Bertrand BRASSENS,UG,10491,14.25,22.03,Qualif
60,05,47611,299,704,48614,25031,73645,M. Pierre VATIN,LR,8427,11.44,17.7,Battu
60,05,47611,299,704,48614,25031,73645,M. Etienne DIOT,ENS,7232,9.82,15.19,Battu
60,05,47611,299,704,48614,25031,73645,Mme Véronique ROGEZ,DSV,509,0.69,1.07,Battu
60,05,47611,299,704,48614,25031,73645,Mme Hélène BECHERINI,EXG,503,0.68,1.06,Battu
60,05,47611,299,704,48614,25031,73645,M. Jean-Paul BOUCHER,REC,379,0.51,0.8,Battu
60,06,48879,352,996,50227,25629,75856,M. Michel GUINIOT,RN,23402,30.85,47.88,Qualif
60,06,48879,352,996,50227,25629,75856,M. Daniel LECA,UDI,11207,14.77,22.93,Qualif
60,06,48879,352,996,50227,25629,75856,M. Baptiste DE FRESSE DE MONVAL,UG,9999,13.18,20.46,Qualif
60,06,48879,352,996,50227,25629,75856,Mme Nathalie CHARRUAU,DVD,2766,3.65,5.66,Battu
60,06,48879,352,996,50227,25629,75856,M. Guy-Eric IMBERT,REC,857,1.13,1.75,Battu
60,06,48879,352,996,50227,25629,75856,M. Jean-Marc ISKIN,EXG,648,0.85,1.33,Battu
60,07,48891,313,749,49953,27165,77118,M. David MAGNIER,RN,19769,25.63,40.43,Qualif
60,07,48891,313,749,49953,27165,77118,M. Loïc PEN,UG,13289,17.23,27.18,Qualif
60,07,48891,313,749,49953,27165,77118,M. Maxime MINOT,LR,10519,13.64,21.52,Qualif
60,07,48891,313,749,49953,27165,77118,Mme Ophélie VAN ELSUWE,ENS,4006,5.19,8.19,Battu
60,07,48891,313,749,49953,27165,77118,Mme Agnès DINGIVAL,EXG,615,0.8,1.26,Battu
60,07,48891,313,749,49953,27165,77118,Mme Florence ITALIANI,REC,415,0.54,0.85,Battu
60,07,48891,313,749,49953,27165,77118,M. Thomas MONGIRAUD,DSV,278,0.36,0.57,Battu
61,01,44869,417,941,46227,21957,68184,Mme Nadine BELZIDSKY,RN,15783,23.15,35.18,Qualif
61,01,44869,417,941,46227,21957,68184,Mme Chantal JOURDAN,UG,12264,17.99,27.33,Qualif
61,01,44869,417,941,46227,21957,68184,Mme Patricia CHAPELOTTE,ENS,9658,14.16,21.52,Qualif
61,01,44869,417,941,46227,21957,68184,Mme Manuela CHEVALIER,DVC,5405,7.93,12.05,Battu
61,01,44869,417,941,46227,21957,68184,M. David GÉNITEAU,DSV,570,0.84,1.27,Battu
61,01,44869,417,941,46227,21957,68184,Mme Camille PERCHET,EXG,476,0.7,1.06,Battu
61,01,44869,417,941,46227,21957,68184,M. Daniel LECOMTE,REC,450,0.66,1,Battu
61,01,44869,417,941,46227,21957,68184,M. Didier DURANDY,DVD,263,0.39,0.59,Battu
61,02,43739,266,719,44724,19812,64536,M. Gérard VIENNE,RN,17502,27.12,40.01,Qualif
61,02,43739,266,719,44724,19812,64536,Mme Véronique LOUWAGIE,DVD,14411,22.33,32.95,Qualif
61,02,43739,266,719,44724,19812,64536,M. Guillaume SACRISTE,UG,7336,11.37,16.77,Battu
61,02,43739,266,719,44724,19812,64536,Mme Amale EL KHALEDI,ENS,3060,4.74,7,Battu
61,02,43739,266,719,44724,19812,64536,Mme Bernadette VELLY,EXG,470,0.73,1.07,Battu
61,02,43739,266,719,44724,19812,64536,Mme Séverine PREHU,DSV,456,0.71,1.04,Battu
61,02,43739,266,719,44724,19812,64536,M. Raymond HERBRETEAU,REC,455,0.71,1.04,Battu
61,02,43739,266,719,44724,19812,64536,M. Patrick LEVACHER,DIV,49,0.08,0.11,Battu
61,03,47398,310,795,48503,22150,70653,M. Jérôme NURY,DVD,20701,29.3,43.67,Qualif
61,03,47398,310,795,48503,22150,70653,Mme Ludmila PETCHENINA,RN,15364,21.75,32.41,Qualif
61,03,47398,310,795,48503,22150,70653,M. Lori HELLOCO,UG,9988,14.14,21.07,Qualif
61,03,47398,310,795,48503,22150,70653,M. Arnaud GAUTIER,EXG,857,1.21,1.81,Battu
61,03,47398,310,795,48503,22150,70653,Mme Sylvia HENOT,REC,488,0.69,1.03,Battu
62,01,71668,715,1295,73678,31569,105247,M. Emmanuel BLAIRY,RN,38755,36.82,54.08,Elu
62,01,71668,715,1295,73678,31569,105247,M. Philippe BOLET,ENS,9613,9.13,13.41,Battu
62,01,71668,715,1295,73678,31569,105247,Mme Marie BERNARD,LR,9026,8.58,12.59,Battu
62,01,71668,715,1295,73678,31569,105247,M. Jean-Michel SAUVAGE,UG,6957,6.61,9.71,Battu
62,01,71668,715,1295,73678,31569,105247,M. Jean-Jacques COTTEL,DVG,6637,6.31,9.26,Battu
62,01,71668,715,1295,73678,31569,105247,Mme Marie BERTHOUD,EXG,680,0.65,0.95,Battu
62,02,59603,484,981,61068,27528,88596,M. Alban HEUSÈLE,RN,22239,25.1,37.31,Qualif
62,02,59603,484,981,61068,27528,88596,Mme Agnès PANNIER-RUNACHER,ENS,12838,14.49,21.54,Qualif
62,02,59603,484,981,61068,27528,88596,M. Alexandre COUSIN,UG,11991,13.53,20.12,Qualif
62,02,59603,484,981,61068,27528,88596,M. Nicolas DESFACHELLE,DVC,8303,9.37,13.93,Battu
62,02,59603,484,981,61068,27528,88596,Mme Mabrouka DHIFALLAH,LR,2180,2.46,3.66,Battu
62,02,59603,484,981,61068,27528,88596,M. Bruno LADSOUS,ECO,946,1.07,1.59,Battu
62,02,59603,484,981,61068,27528,88596,Mme Nathalie LEBLANC,REC,697,0.79,1.17,Battu
62,02,59603,484,981,61068,27528,88596,Mme Béatrice BOUFFART,EXG,409,0.46,0.69,Battu
62,03,48089,427,824,49340,33701,83041,M. Bruno CLAVET,RN,25200,30.35,52.4,Elu
62,03,48089,427,824,49340,33701,83041,M. Jean-Marc TELLIER,UG,15530,18.7,32.29,Battu
62,03,48089,427,824,49340,33701,83041,M. François QUESTE,ENS,4427,5.33,9.21,Battu
62,03,48089,427,824,49340,33701,83041,M. Jacques DUQUENNE,UDI,1586,1.91,3.3,Battu
62,03,48089,427,824,49340,33701,83041,M. Michel DARRAS,EXG,800,0.96,1.66,Battu
62,03,48089,427,824,49340,33701,83041,Mme Michèle LEJEUNE,REC,546,0.66,1.14,Battu
62,04,59718,501,1089,61308,28655,89963,M. Benoît DOLLE,RN,25286,28.11,42.34,Qualif
62,04,59718,501,1089,61308,28655,89963,M. Philippe FAIT,ENS,18309,20.35,30.66,Qualif
62,04,59718,501,1089,61308,28655,89963,Mme Blandine DRAIN,UG,8794,9.78,14.73,Battu
62,04,59718,501,1089,61308,28655,89963,Mme Clémence LAMBERT,LR,5501,6.11,9.21,Battu
62,04,59718,501,1089,61308,28655,89963,M. Jérémy DURAND,DVC,935,1.04,1.57,Battu
62,04,59718,501,1089,61308,28655,89963,Mme Fanny JUDEK,REC,445,0.49,0.75,Battu
62,04,59718,501,1089,61308,28655,89963,M. Dominique HERICOURT,EXG,442,0.49,0.74,Battu
62,04,59718,501,1089,61308,28655,89963,M. Jean-Marc SERGENT,DIV,6,0.01,0.01,Battu
62,05,55564,351,869,56784,34122,90906,M. Antoine GOLLIOT,RN,23974,26.37,43.15,Qualif
62,05,55564,351,869,56784,34122,90906,M. Olivier BARBARIN,UG,16095,17.71,28.97,Qualif
62,05,55564,351,869,56784,34122,90906,M. Jean-Pierre PONT,ENS,11601,12.76,20.88,Qualif
62,05,55564,351,869,56784,34122,90906,M. Jean-Luc VIUDES,LR,2596,2.86,4.67,Battu
62,05,55564,351,869,56784,34122,90906,M. Pierre LANGLET,EXG,1298,1.43,2.34,Battu
62,06,64203,648,1163,66014,28629,94643,Mme Christine ENGRAND,RN,32553,34.4,50.7,Elu
62,06,64203,648,1163,66014,28629,94643,Mme Brigitte BOURGUIGNON,ENS,17052,18.02,26.56,Battu
62,06,64203,648,1163,66014,28629,94643,Mme Aurore PAGEAUD,UG,9065,9.58,14.12,Battu
62,06,64203,648,1163,66014,28629,94643,M. Eric HOUDAYER,LR,4495,4.75,7,Battu
62,06,64203,648,1163,66014,28629,94643,Mme Laure BOUREL,EXG,703,0.74,1.09,Battu
62,06,64203,648,1163,66014,28629,94643,M. Giovanni Anthony FRATTINI,DIV,335,0.35,0.52,Battu
62,07,56408,423,779,57610,37049,94659,M. Marc DE FLEURIAN,RN,26995,28.52,47.86,Qualif
62,07,56408,423,779,57610,37049,94659,M. Pierre-Henri DUMONT,LR,19036,20.11,33.75,Qualif
62,07,56408,423,779,57610,37049,94659,M. Jean-Pierre MOUSSALLY,UG,9184,9.7,16.28,Battu
62,07,56408,423,779,57610,37049,94659,M. Olivier CARRAUD,EXG,701,0.74,1.24,Battu
62,07,56408,423,779,57610,37049,94659,M. Jérôme JUDEK,REC,492,0.52,0.87,Battu
62,08,58485,627,934,60046,32342,92388,M. Auguste EVRARD,RN,27164,29.4,46.45,Qualif
62,08,58485,627,934,60046,32342,92388,M. Bertrand PETIT,UG,18697,20.24,31.97,Qualif
62,08,58485,627,934,60046,32342,92388,M. Benoît POTTERIE,ENS,9824,10.63,16.8,Battu
62,08,58485,627,934,60046,32342,92388,M. Hervé RUFFIN,EXG,1199,1.3,2.05,Battu
62,08,58485,627,934,60046,32342,92388,M. Alain ATASSI,DIV,984,1.07,1.68,Battu
62,08,58485,627,934,60046,32342,92388,M. Jérémie WEBER,REC,617,0.67,1.05,Battu
62,09,52558,514,1009,54081,26681,80762,Mme Caroline PARMENTIER,RN,25674,31.79,48.85,Qualif
62,09,52558,514,1009,54081,26681,80762,M. Hadrien COISNE,ENS,10394,12.87,19.78,Qualif
62,09,52558,514,1009,54081,26681,80762,Mme Estelle HARREMOES,UG,8881,11,16.9,Battu
62,09,52558,514,1009,54081,26681,80762,M. Hakim ELAZOUZI,UDI,6985,8.65,13.29,Battu
62,09,52558,514,1009,54081,26681,80762,Mme Anne-Marie DEFLANDRE,EXG,624,0.77,1.19,Battu
62,09,52558,514,1009,54081,26681,80762,M. Julien GUAQUIER,DVD,0,0,0,Battu
62,10,53672,569,1136,55377,33718,89095,M. Thierry FRAPPÉ,RN,32530,36.51,60.61,Elu
62,10,53672,569,1136,55377,33718,89095,Mme Emmanuelle LEVEUGLE,UG,10085,11.32,18.79,Battu
62,10,53672,569,1136,55377,33718,89095,M. Thomas BUTTIN,LR,5635,6.32,10.5,Battu
62,10,53672,569,1136,55377,33718,89095,M. Léo LUNIEWSKI,ENS,4571,5.13,8.52,Battu
62,10,53672,569,1136,55377,33718,89095,M. Éric ROBASZKIEWICZ,EXG,851,0.96,1.59,Battu
62,11,56308,601,1225,58134,36032,94166,Mme Marine LE PEN,RN,32681,34.71,58.04,Elu
62,11,56308,601,1225,58134,36032,94166,Mme Samira LAAL,UG,14666,15.57,26.05,Battu
62,11,56308,601,1225,58134,36032,94166,M. Dorian LAMY,ENS,4269,4.53,7.58,Battu
62,11,56308,601,1225,58134,36032,94166,M. Michel LANOY,LR,2676,2.84,4.75,Battu
62,11,56308,601,1225,58134,36032,94166,M. Geoffrey FOURNIER,REC,813,0.86,1.44,Battu
62,11,56308,601,1225,58134,36032,94166,Mme Dominique GAI,EXG,786,0.83,1.4,Battu
62,11,56308,601,1225,58134,36032,94166,M. Gautier WEINMANN,DVG,417,0.44,0.74,Battu
62,12,57302,661,1476,59439,37350,96789,M. Bruno BILDE,RN,33944,35.07,59.24,Elu
62,12,57302,661,1476,59439,37350,96789,M. Alain BAVAY,UG,12059,12.46,21.04,Battu
62,12,57302,661,1476,59439,37350,96789,M. Steve BOSSART,DVC,10178,10.52,17.76,Battu
62,12,57302,661,1476,59439,37350,96789,M. Régis SCHEENAERTS,EXG,1121,1.16,1.96,Battu
63,01,54645,488,948,56081,27707,83788,Mme Marianne MAXIMI,UG,20841,24.87,38.14,Qualif
63,01,54645,488,948,56081,27707,83788,M. Louis CLÉMENT,RN,15025,17.93,27.5,Qualif
63,01,54645,488,948,56081,27707,83788,M. Hervé PRONONCE,ENS,13156,15.7,24.08,Qualif
63,01,54645,488,948,56081,27707,83788,M. Sébastien GALPIER,LR,4890,5.84,8.95,Battu
63,01,54645,488,948,56081,27707,83788,M. Dominique LECLAIR,EXG,733,0.87,1.34,Battu
63,02,64017,628,1176,65821,24462,90283,Mme Christine PIRÈS BEAUNE,UG,23175,25.67,36.2,Qualif
63,02,64017,628,1176,65821,24462,90283,Mme Isabelle DUPRÉ,RN,21986,24.35,34.34,Qualif
63,02,64017,628,1176,65821,24462,90283,Mme Sarah CHAUVIN,LR,9044,10.02,14.13,Battu
63,02,64017,628,1176,65821,24462,90283,M. Jean-Paul LEBREC,ENS,8203,9.09,12.81,Battu
63,02,64017,628,1176,65821,24462,90283,M. Franck TRUCHON,EXG,969,1.07,1.51,Battu
63,02,64017,628,1176,65821,24462,90283,Mme Marion GODU,REC,640,0.71,1,Battu
63,03,64541,562,1154,66257,23937,90194,M. Nicolas BONNET,UG,20470,22.7,31.72,Qualif
63,03,64541,562,1154,66257,23937,90194,Mme Laurence VICHNIEVSKY,ENS,16800,18.63,26.03,Qualif
63,03,64541,562,1154,66257,23937,90194,Mme Nadine PERS,RN,16735,18.55,25.93,Qualif
63,03,64541,562,1154,66257,23937,90194,Mme Marie-Anne MARCHIS,LR,8863,9.83,13.73,Battu
63,03,64541,562,1154,66257,23937,90194,Mme Marie SAVRE,EXG,759,0.84,1.18,Battu
63,03,64541,562,1154,66257,23937,90194,M. Patrick FINOTTO,REC,573,0.64,0.89,Battu
63,03,64541,562,1154,66257,23937,90194,M. Louis DUPIC,DVD,277,0.31,0.43,Battu
63,03,64541,562,1154,66257,23937,90194,M. René ONDET,DVG,64,0.07,0.1,Battu
63,04,70479,813,1510,72802,29179,101981,M. Benjamin CHALUS,RN,22289,21.86,31.63,Qualif
63,04,70479,813,1510,72802,29179,101981,Mme Delphine LINGEMANN,ENS,19299,18.92,27.38,Qualif
63,04,70479,813,1510,72802,29179,101981,Mme Valérie GOLÉO,UG,18769,18.4,26.63,Qualif
63,04,70479,813,1510,72802,29179,101981,Mme Florence DUBESSY,LR,8419,8.26,11.95,Battu
63,04,70479,813,1510,72802,29179,101981,M. François MAROTTE,EXG,1137,1.11,1.61,Battu
63,04,70479,813,1510,72802,29179,101981,Mme Pascale SANCHEZ,REC,566,0.56,0.8,Battu
63,05,71832,773,1340,73945,31135,105080,M. André CHASSAIGNE,UG,27134,25.82,37.77,Qualif
63,05,71832,773,1340,73945,31135,105080,Mme Brigitte CARLETTO,RN,26595,25.31,37.02,Qualif
63,05,71832,773,1340,73945,31135,105080,Mme Véronique BASTET,ENS,11166,10.63,15.54,Battu
63,05,71832,773,1340,73945,31135,105080,M. Yves COURTHALIAC,LR,6154,5.86,8.57,Battu
63,05,71832,773,1340,73945,31135,105080,Mme Gabrielle CAPRON,EXG,783,0.75,1.09,Battu
64,01,48244,351,813,49408,20039,69447,M. François VERRIERE,RN,13490,19.42,27.96,Qualif
64,01,48244,351,813,49408,20039,69447,Mme Josy POUEYTO,ENS,12939,18.63,26.82,Qualif
64,01,48244,351,813,49408,20039,69447,M. Jean-Yves LALANNE,DVG,9625,13.86,19.95,Qualif
64,01,48244,351,813,49408,20039,69447,M. Jean SANROMAN,UG,6305,9.08,13.07,Battu
64,01,48244,351,813,49408,20039,69447,Mme Sandrine LAFARGUE,LR,4304,6.2,8.92,Battu
64,01,48244,351,813,49408,20039,69447,M. Jérémy ZEN,ECO,1215,1.75,2.52,Battu
64,01,48244,351,813,49408,20039,69447,Mme Agnès HEGOBURU,EXG,366,0.53,0.76,Battu
64,02,60718,508,1130,62356,22316,84672,Mme Monique BECKER,RN,18910,22.33,31.14,Qualif
64,02,60718,508,1130,62356,22316,84672,M. Jean-Paul MATTEÏ,ENS,17972,21.23,29.6,Qualif
64,02,60718,508,1130,62356,22316,84672,M. Julien BRUNEL,UG,16083,18.99,26.49,Qualif
64,02,60718,508,1130,62356,22316,84672,M. Marc LABAT,LR,4647,5.49,7.65,Battu
64,02,60718,508,1130,62356,22316,84672,M. Jacques MAUHOURAT,ECO,1497,1.77,2.47,Battu
64,02,60718,508,1130,62356,22316,84672,M. Patrici CESCAU,REG,1079,1.27,1.78,Battu
64,02,60718,508,1130,62356,22316,84672,M. Cyrille MARCONI,EXG,530,0.63,0.87,Battu
64,03,59181,402,974,60557,23372,83929,M. David HABIB,DVG,22271,26.54,37.63,Qualif
64,03,59181,402,974,60557,23372,83929,M. Nicolas CRESSON,RN,18670,22.24,31.55,Qualif
64,03,59181,402,974,60557,23372,83929,Mme Joëlle LOSSON,UG,10255,12.22,17.33,Battu
64,03,59181,402,974,60557,23372,83929,M. Gilles MARDELLE,LR,5998,7.15,10.14,Battu
64,03,59181,402,974,60557,23372,83929,M. Kévin BRIOLAIS,ECO,1154,1.37,1.95,Battu
64,03,59181,402,974,60557,23372,83929,M. Audric ARMAND MÈGE,REG,475,0.57,0.8,Battu
64,03,59181,402,974,60557,23372,83929,M. Antoine MISSIER,EXG,358,0.43,0.6,Battu
64,04,57795,422,928,59145,21647,80792,M. Iñaki ECHANIZ,UG,21968,27.19,38.01,Qualif
64,04,57795,422,928,59145,21647,80792,Mme Sylviane LOPEZ,RN,14806,18.33,25.62,Qualif
64,04,57795,422,928,59145,21647,80792,M. Jean LASSALLE,DVD,10434,12.91,18.05,Qualif
64,04,57795,422,928,59145,21647,80792,M. Beñat CACHENAUT,LR,8983,11.12,15.54,Battu
64,04,57795,422,928,59145,21647,80792,Mme Gracianne MIRANDE BEC,REG,1128,1.4,1.95,Battu
64,04,57795,422,928,59145,21647,80792,M. Carlos RIBEIRO,EXG,476,0.59,0.82,Battu
64,05,70109,488,1073,71670,29466,101136,Mme Colette CAPDEVIELLE,UG,22643,22.39,32.3,Qualif
64,05,70109,488,1073,71670,29466,101136,M. Serge ROSSO,RN,19308,19.09,27.54,Qualif
64,05,70109,488,1073,71670,29466,101136,Mme Florence LASSERRE,ENS,18667,18.46,26.63,Qualif
64,05,70109,488,1073,71670,29466,101136,Mme Valérie CASTREC,LR,4198,4.15,5.99,Battu
64,05,70109,488,1073,71670,29466,101136,Mme Johanna GRATELOUP,ECO,1567,1.55,2.24,Battu
64,05,70109,488,1073,71670,29466,101136,M. Jean-Marie ERRAMUZPE,REG,1414,1.4,2.02,Battu
64,05,70109,488,1073,71670,29466,101136,M. Jean Claude LABADIE,DIV,1010,1,1.44,Battu
64,05,70109,488,1073,71670,29466,101136,M. Alain CAYUELA,REC,671,0.66,0.96,Battu
64,05,70109,488,1073,71670,29466,101136,M. Philippe BARDANOUVE,EXG,477,0.47,0.68,Battu
64,05,70109,488,1073,71670,29466,101136,Mme Hélène SUSBIELLE,REG,154,0.15,0.22,Battu
64,06,73578,562,1390,75530,31087,106617,M. Peio DUFAU,UG,21650,20.31,29.42,Qualif
64,06,73578,562,1390,75530,31087,106617,M. Christian DEVÈZE,ENS,19806,18.58,26.92,Qualif
64,06,73578,562,1390,75530,31087,106617,M. Victor LASTÉCOUÈRES,UXD,18610,17.46,25.29,Qualif
64,06,73578,562,1390,75530,31087,106617,Mme Emmanuelle BRISSON,LR,8546,8.02,11.61,Battu
64,06,73578,562,1390,75530,31087,106617,M. Jean TELLECHEA,REG,3712,3.48,5.04,Battu
64,06,73578,562,1390,75530,31087,106617,Mme Jacqueline UHART,EXG,844,0.79,1.15,Battu
64,06,73578,562,1390,75530,31087,106617,Mme Eva PERNET,DVC,248,0.23,0.34,Battu
64,06,73578,562,1390,75530,31087,106617,Mme Corinne BERTHELOT,DIV,161,0.15,0.22,Battu
64,06,73578,562,1390,75530,31087,106617,M. Michel LAMARQUE,DIV,1,0,0,Battu
65,01,59474,634,1386,61494,25834,87328,Mme Marie-Christine SORIN,RN,20272,23.21,34.09,Qualif
65,01,59474,634,1386,61494,25834,87328,Mme Sylvie FERRER,UG,17564,20.11,29.53,Qualif
65,01,59474,634,1386,61494,25834,87328,M. Jean-Bernard SEMPASTOUS,DIV,14776,16.92,24.84,Qualif
65,01,59474,634,1386,61494,25834,87328,M. Philippe EVON,LR,3047,3.49,5.12,Battu
65,01,59474,634,1386,61494,25834,87328,M. Pierre CLARET,DIV,2626,3.01,4.42,Battu
65,01,59474,634,1386,61494,25834,87328,Mme Catherine BONNECARRERE,REC,656,0.75,1.1,Battu
65,01,59474,634,1386,61494,25834,87328,Mme Maria SAEZ,EXG,533,0.61,0.9,Battu
65,02,60709,662,1422,62793,25703,88496,M. Olivier MONTEIL,RN,22436,25.35,36.96,Qualif
65,02,60709,662,1422,62793,25703,88496,M. Denis FÉGNÉ,UG,17055,19.27,28.09,Qualif
65,02,60709,662,1422,62793,25703,88496,M. Benoit MOURNET,ENS,15121,17.09,24.91,Qualif
65,02,60709,662,1422,62793,25703,88496,M. Jacques BÉHAGUE,LR,3184,3.6,5.24,Battu
65,02,60709,662,1422,62793,25703,88496,M. Jean-Marc DABAT,REG,1486,1.68,2.45,Battu
65,02,60709,662,1422,62793,25703,88496,M. Claude ALVES DA CUNHA,REC,735,0.83,1.21,Battu
65,02,60709,662,1422,62793,25703,88496,M. François MEUNIER,EXG,692,0.78,1.14,Battu
65,02,60709,662,1422,62793,25703,88496,M. Ali EL MARSNI,DIV,0,0,0,Battu
66,01,47821,504,768,49093,24965,74058,Mme Sophie BLANC,RN,21633,29.21,45.24,Qualif
66,01,47821,504,768,49093,24965,74058,M. Francis DASPE,UG,12184,16.45,25.48,Qualif
66,01,47821,504,768,49093,24965,74058,M. Christophe EUZET,ENS,7720,10.42,16.14,Battu
66,01,47821,504,768,49093,24965,74058,Mme Annabelle BRUNET,DVC,2328,3.14,4.87,Battu
66,01,47821,504,768,49093,24965,74058,M. Loïc MOSZKOWIEZ,LR,2092,2.82,4.37,Battu
66,01,47821,504,768,49093,24965,74058,Mme Delphine DANAT,REG,790,1.07,1.65,Battu
66,01,47821,504,768,49093,24965,74058,M. Jacques CATALDO,REC,700,0.95,1.46,Battu
66,01,47821,504,768,49093,24965,74058,Mme Pascale ADVENARD,EXG,374,0.51,0.78,Battu
66,02,69703,751,1393,71847,34310,106157,Mme Anaïs SABATINI,RN,38323,36.1,54.98,Elu
66,02,69703,751,1393,71847,34310,106157,M. Marc MEDINA,DVC,14257,13.43,20.45,Battu
66,02,69703,751,1393,71847,34310,106157,M. David BERRUÉ,UG,13910,13.1,19.96,Battu
66,02,69703,751,1393,71847,34310,106157,Mme Mercedes GARCIA,REG,1337,1.26,1.92,Battu
66,02,69703,751,1393,71847,34310,106157,Mme Brigitte LAURENS,REC,1258,1.19,1.8,Battu
66,02,69703,751,1393,71847,34310,106157,M. Philippe GOISET,EXG,618,0.58,0.89,Battu
66,03,55660,717,1417,57794,27856,85650,Mme Sandrine DOGOR-SUCH,RN,25363,29.61,45.57,Qualif
66,03,55660,717,1417,57794,27856,85650,Mme Nathalie CULLELL,UG,15603,18.22,28.03,Qualif
66,03,55660,717,1417,57794,27856,85650,Mme Laurence GAYTE,ENS,11367,13.27,20.42,Qualif
66,03,55660,717,1417,57794,27856,85650,Mme Lucila GRAU,REG,1780,2.08,3.2,Battu
66,03,55660,717,1417,57794,27856,85650,M. Alexandre MICHAUT,REC,935,1.09,1.68,Battu
66,03,55660,717,1417,57794,27856,85650,Mme Anna-Maria URROZ,EXG,612,0.71,1.1,Battu
66,04,69231,810,1301,71342,31400,102742,Mme Michèle MARTINEZ,RN,33159,32.27,47.9,Qualif
66,04,69231,810,1301,71342,31400,102742,M. Julien BARAILLÉ,UG,17963,17.48,25.95,Qualif
66,04,69231,810,1301,71342,31400,102742,Mme Patricia NADAL,ENS,11454,11.15,16.54,Battu
66,04,69231,810,1301,71342,31400,102742,M. Philippe ROMAIN,LR,3183,3.1,4.6,Battu
66,04,69231,810,1301,71342,31400,102742,Mme Celine DAVESA,REG,1937,1.89,2.8,Battu
66,04,69231,810,1301,71342,31400,102742,Mme Odile MAISONNEUVE,REC,960,0.93,1.39,Battu
66,04,69231,810,1301,71342,31400,102742,Mme Caroline POUPARD,EXG,575,0.56,0.83,Battu
67,01,43339,143,321,43803,18738,62541,Mme Sandra REGOL,UG,20631,32.99,47.6,Qualif
67,01,43339,143,321,43803,18738,62541,M. Etienne LOOS,ENS,10513,16.81,24.26,Qualif
67,01,43339,143,321,43803,18738,62541,Mme Hombeline DU PARC,RN,6081,9.72,14.03,Battu
67,01,43339,143,321,43803,18738,62541,Mme Irène WEISS,LR,2787,4.46,6.43,Battu
67,01,43339,143,321,43803,18738,62541,M. Serge OEHLER,DVG,835,1.34,1.93,Battu
67,01,43339,143,321,43803,18738,62541,M. Jamal ROUCHDI,DIV,472,0.75,1.09,Battu
67,01,43339,143,321,43803,18738,62541,M. Luc MENARD,REC,436,0.7,1.01,Battu
67,01,43339,143,321,43803,18738,62541,M. Patrick ARBOGAST,ECO,424,0.68,0.98,Battu
67,01,43339,143,321,43803,18738,62541,Mme Odette HOLTZER,REG,395,0.63,0.91,Battu
67,01,43339,143,321,43803,18738,62541,M. Albéric BARRET,ECO,315,0.5,0.73,Battu
67,01,43339,143,321,43803,18738,62541,Mme Louise FÈVE,EXG,146,0.23,0.34,Battu
67,01,43339,143,321,43803,18738,62541,M. Frédéric SEIGLE-MURANDI,DVG,107,0.17,0.25,Battu
67,01,43339,143,321,43803,18738,62541,M. Thomas BRANT,DIV,77,0.12,0.18,Battu
67,01,43339,143,321,43803,18738,62541,M. Dan BENHAMOU,EXG,77,0.12,0.18,Battu
67,01,43339,143,321,43803,18738,62541,M. Thomas SCHLUND,DIV,43,0.07,0.1,Battu
67,01,43339,143,321,43803,18738,62541,M. Etienne GENIEUX,EXG,0,0,0,Battu
67,02,49041,209,476,49726,23266,72992,M. Emmanuel FERNANDES,UG,21533,29.5,43.91,Qualif
67,02,49041,209,476,49726,23266,72992,Mme Rebecca BREITMAN,ENS,11063,15.16,22.56,Qualif
67,02,49041,209,476,49726,23266,72992,Mme Virginie JORON,RN,10407,14.26,21.22,Qualif
67,02,49041,209,476,49726,23266,72992,M. Alexandre WOLF SAMALOUSSI,LR,3287,4.5,6.7,Battu
67,02,49041,209,476,49726,23266,72992,Mme Cendrine DIEMUNSCH,REG,819,1.12,1.67,Battu
67,02,49041,209,476,49726,23266,72992,M. Jean Marc GOVERNATORI,ECO,685,0.94,1.4,Battu
67,02,49041,209,476,49726,23266,72992,Mme Fabienne SCHNITZLER,ECO,473,0.65,0.96,Battu
67,02,49041,209,476,49726,23266,72992,Mme Elisa CLOLOT,DVG,358,0.49,0.73,Battu
67,02,49041,209,476,49726,23266,72992,M. Alain RICHARD,EXG,262,0.36,0.53,Battu
67,02,49041,209,476,49726,23266,72992,M. Clément SOUBISE,EXG,154,0.21,0.31,Battu
67,03,45744,257,467,46468,24477,70945,M. Thierry SOTHER,UG,17355,24.46,37.94,Qualif
67,03,45744,257,467,46468,24477,70945,M. Bruno STUDER,ENS,13260,18.69,28.99,Qualif
67,03,45744,257,467,46468,24477,70945,Mme Stéphanie DÔ,RN,10567,14.89,23.1,Qualif
67,03,45744,257,467,46468,24477,70945,M. Dera RATSIAJETSINIMARO,LR,1760,2.48,3.85,Battu
67,03,45744,257,467,46468,24477,70945,M. Gautier PERRIN,REG,813,1.15,1.78,Battu
67,03,45744,257,467,46468,24477,70945,M. Thierry PARAT,ECO,782,1.1,1.71,Battu
67,03,45744,257,467,46468,24477,70945,M. Alexandre ZYZECK,REC,420,0.59,0.92,Battu
67,03,45744,257,467,46468,24477,70945,M. Mohamed SYLLA,DVG,294,0.41,0.64,Battu
67,03,45744,257,467,46468,24477,70945,Mme Denise GRANDMOUGIN,EXG,252,0.36,0.55,Battu
67,03,45744,257,467,46468,24477,70945,M. Félix KLEIMANN,DVG,129,0.18,0.28,Battu
67,03,45744,257,467,46468,24477,70945,M. Hicham HAMZA,DIV,112,0.16,0.24,Battu
67,03,45744,257,467,46468,24477,70945,Mme Camille ROBERT,EXG,0,0,0,Battu
67,04,68325,360,902,69587,29462,99049,Mme Delphine DAUBENBERGER,RN,22625,22.84,33.11,Qualif
67,04,68325,360,902,69587,29462,99049,Mme Françoise BUFFET,ENS,22107,22.32,32.36,Qualif
67,04,68325,360,902,69587,29462,99049,Mme Raphaële KRATTINGER,UG,14297,14.43,20.92,Qualif
67,04,68325,360,902,69587,29462,99049,Mme Nelly AESCHELMANN,LR,3936,3.97,5.76,Battu
67,04,68325,360,902,69587,29462,99049,Mme Catherine BERTHOL,DVD,2389,2.41,3.5,Battu
67,04,68325,360,902,69587,29462,99049,Mme Bénédicte MATZ,REG,1982,2,2.9,Battu
67,04,68325,360,902,69587,29462,99049,M. Jean-Louis BIGOT,REC,645,0.65,0.94,Battu
67,04,68325,360,902,69587,29462,99049,M. Mehdi BENHLAL,EXG,344,0.35,0.5,Battu
67,05,71159,464,1007,72630,34964,107594,M. Thomas ESTEVE,RN,27897,25.93,39.2,Qualif
67,05,71159,464,1007,72630,34964,107594,M. Charles SITZENSTUHL,ENS,22993,21.37,32.31,Qualif
67,05,71159,464,1007,72630,34964,107594,M. Marc RUHLMANN,UG,12043,11.19,16.92,Battu
67,05,71159,464,1007,72630,34964,107594,M. Leo COUTAUD,LR,3529,3.28,4.96,Battu
67,05,71159,464,1007,72630,34964,107594,Mme Sarah WEISS MOESSMER,REG,2681,2.49,3.77,Battu
67,05,71159,464,1007,72630,34964,107594,M. Christian DANTZ,ECO,803,0.75,1.13,Battu
67,05,71159,464,1007,72630,34964,107594,M. Bastien MACIA,DSV,767,0.71,1.08,Battu
67,05,71159,464,1007,72630,34964,107594,M. Patrick DUTTER,EXG,446,0.41,0.63,Battu
67,06,65657,355,923,66935,31287,98222,M. Vincent COUSSEDIERE,RN,25275,25.73,38.5,Qualif
67,06,65657,355,923,66935,31287,98222,Mme Louise MOREL,ENS,18228,18.56,27.76,Qualif
67,06,65657,355,923,66935,31287,98222,M. Didier ANDRES,UG,10076,10.26,15.35,Battu
67,06,65657,355,923,66935,31287,98222,M. Jean BIEHLER,LR,8739,8.9,13.31,Battu
67,06,65657,355,923,66935,31287,98222,Mme Carine HAMM,REG,1770,1.8,2.7,Battu
67,06,65657,355,923,66935,31287,98222,Mme Patricia MARLE,DSV,634,0.65,0.97,Battu
67,06,65657,355,923,66935,31287,98222,Mme Sabrina RITTER,REC,494,0.5,0.75,Battu
67,06,65657,355,923,66935,31287,98222,M. René CAMUS,EXG,362,0.37,0.55,Battu
67,06,65657,355,923,66935,31287,98222,M. Ryan GEYER,DIV,79,0.08,0.12,Battu
67,07,55633,374,800,56807,29335,86142,M. Denis KIEFFER,RN,23071,26.78,41.47,Qualif
67,07,55633,374,800,56807,29335,86142,M. Patrick HETZEL,LR,17974,20.87,32.31,Qualif
67,07,55633,374,800,56807,29335,86142,M. Serge BLOCH,UG,6912,8.02,12.42,Battu
67,07,55633,374,800,56807,29335,86142,M. Eric WOLFF,ENS,4734,5.5,8.51,Battu
67,07,55633,374,800,56807,29335,86142,Mme Anastasie LEIPP,REG,1821,2.11,3.27,Battu
67,07,55633,374,800,56807,29335,86142,M. Arthur WOLFF,REC,707,0.82,1.27,Battu
67,07,55633,374,800,56807,29335,86142,M. Jean MEYER,EXG,414,0.48,0.74,Battu
67,08,59584,364,920,60868,33810,94678,M. Théo BERNHARDT,RN,26313,27.79,44.16,Qualif
67,08,59584,364,920,60868,33810,94678,Mme Stéphanie KOCHERT,ENS,14006,14.79,23.51,Qualif
67,08,59584,364,920,60868,33810,94678,M. Victor VOGT,DVD,6818,7.2,11.44,Battu
67,08,59584,364,920,60868,33810,94678,Mme Myriam ZEKAGH,UG,5432,5.74,9.12,Battu
67,08,59584,364,920,60868,33810,94678,M. Christian KLIPFEL,DVD,4731,5,7.94,Battu
67,08,59584,364,920,60868,33810,94678,Mme Claire GROSHEITSCH,ECO,739,0.78,1.24,Battu
67,08,59584,364,920,60868,33810,94678,M. Nathan HACKENSCHMIDT,REC,663,0.7,1.11,Battu
67,08,59584,364,920,60868,33810,94678,Mme Stella BATISSE,DSV,576,0.61,0.97,Battu
67,08,59584,364,920,60868,33810,94678,Mme Catherine GSELL,EXG,306,0.32,0.51,Battu
67,09,62264,360,804,63428,32788,96216,M. Marc WOLFF,RN,25199,26.19,40.47,Qualif
67,09,62264,360,804,63428,32788,96216,M. Vincent THIEBAUT,ENS,18206,18.92,29.24,Qualif
67,09,62264,360,804,63428,32788,96216,M. Olivier TERRIEN,UG,9680,10.06,15.55,Battu
67,09,62264,360,804,63428,32788,96216,M. Philippe PFRIMMER,DVD,5512,5.73,8.85,Battu
67,09,62264,360,804,63428,32788,96216,M. Maurice GLUCK,REG,2583,2.68,4.15,Battu
67,09,62264,360,804,63428,32788,96216,M. Robin GEROLT,REC,678,0.7,1.09,Battu
67,09,62264,360,804,63428,32788,96216,M. Yann LUCAS,EXG,406,0.42,0.65,Battu
68,01,49165,323,721,50209,28778,78987,M. Laurent GNAEDIG,RN,16833,21.31,34.24,Qualif
68,01,49165,323,721,50209,28778,78987,Mme Brigitte KLINKERT,ENS,14945,18.92,30.4,Qualif
68,01,49165,323,721,50209,28778,78987,Mme Aïcha FRITSCH,UG,8727,11.05,17.75,Battu
68,01,49165,323,721,50209,28778,78987,M. Yves HEMEDINGER,LR,6547,8.29,13.32,Battu
68,01,49165,323,721,50209,28778,78987,M. Thiébault ZITVOGEL,REG,1007,1.27,2.05,Battu
68,01,49165,323,721,50209,28778,78987,Mme Cyrielle COUVAL,DSV,591,0.75,1.2,Battu
68,01,49165,323,721,50209,28778,78987,M. Gilles SCHAFFAR,EXG,341,0.43,0.69,Battu
68,01,49165,323,721,50209,28778,78987,Mme Ariane BISCHOFF-BATMA,REC,174,0.22,0.35,Battu
68,02,60959,504,973,62436,30040,92476,Mme Nathalie AUBERT,RN,22049,23.84,36.17,Qualif
68,02,60959,504,973,62436,30040,92476,M. Hubert OTT,ENS,19785,21.39,32.46,Qualif
68,02,60959,504,973,62436,30040,92476,M. Lilian BOURGEOIS,UG,9228,9.98,15.14,Battu
68,02,60959,504,973,62436,30040,92476,M. Daniel KLACK,DVD,5012,5.42,8.22,Battu
68,02,60959,504,973,62436,30040,92476,M. Jean-Marc BURGEL,REG,1645,1.78,2.7,Battu
68,02,60959,504,973,62436,30040,92476,Mme Tiffany STRAUB,DIV,1641,1.77,2.69,Battu
68,02,60959,504,973,62436,30040,92476,Mme Claudine SÉBERT,DSV,679,0.73,1.11,Battu
68,02,60959,504,973,62436,30040,92476,M. Victor OLRY,REC,477,0.52,0.78,Battu
68,02,60959,504,973,62436,30040,92476,M. Pascal NEUSCHWANGER,EXG,280,0.3,0.46,Battu
68,02,60959,504,973,62436,30040,92476,M. Nathan DOUDE VAN TROOSTWIJK,DVG,163,0.18,0.27,Battu
68,03,56075,344,921,57340,30019,87359,M. Christian ZIMMERMANN,RN,21791,24.94,38.86,Qualif
68,03,56075,344,921,57340,30019,87359,M. Didier LEMAIRE,ENS,13980,16,24.93,Qualif
68,03,56075,344,921,57340,30019,87359,M. Thomas ZELLER,DVD,7521,8.61,13.41,Battu
68,03,56075,344,921,57340,30019,87359,Mme Bénédicte VIROULET,UG,7119,8.15,12.7,Battu
68,03,56075,344,921,57340,30019,87359,M. Jean-Denis ZOELLE,REG,1850,2.12,3.3,Battu
68,03,56075,344,921,57340,30019,87359,M. Antoine WAECHTER,ECO,1563,1.79,2.79,Battu
68,03,56075,344,921,57340,30019,87359,Mme Gaelle CRESSIN,ECO,785,0.9,1.4,Battu
68,03,56075,344,921,57340,30019,87359,Mme Sandrine NOEL,REC,653,0.75,1.16,Battu
68,03,56075,344,921,57340,30019,87359,Mme Simone FISCHER,DSV,579,0.66,1.03,Battu
68,03,56075,344,921,57340,30019,87359,M. Géraud FERRY,EXG,234,0.27,0.42,Battu
68,04,67435,364,1211,69010,35227,104237,Mme Marion WILHELM,RN,28234,27.09,41.87,Qualif
68,04,67435,364,1211,69010,35227,104237,M. Raphaël SCHELLENBERGER,LR,19658,18.86,29.15,Qualif
68,04,67435,364,1211,69010,35227,104237,Mme Simone FEST,UG,11408,10.94,16.92,Battu
68,04,67435,364,1211,69010,35227,104237,M. Maxence HELFRICH,REG,3867,3.71,5.73,Battu
68,04,67435,364,1211,69010,35227,104237,Mme Raymonde DIOP,REC,1932,1.85,2.86,Battu
68,04,67435,364,1211,69010,35227,104237,Mme Corinne MORGEN,ECO,1754,1.68,2.6,Battu
68,04,67435,364,1211,69010,35227,104237,M. Aime SENSE,EXG,582,0.56,0.86,Battu
68,05,47680,143,1090,48913,27176,76089,M. Olivier BECHT,ENS,17749,23.33,37.23,Qualif
68,05,47680,143,1090,48913,27176,76089,M. Pierre PINTO,RN,14096,18.53,29.56,Qualif
68,05,47680,143,1090,48913,27176,76089,Mme Nadia EL HAJJAJI,UG,12776,16.79,26.8,Qualif
68,05,47680,143,1090,48913,27176,76089,M. Jean-Frédéric BAECHLER,REG,1104,1.45,2.32,Battu
68,05,47680,143,1090,48913,27176,76089,M. Rachid LOUNES,ECO,567,0.75,1.19,Battu
68,05,47680,143,1090,48913,27176,76089,M. Emmanuel TAFFARELLI,REC,544,0.71,1.14,Battu
68,05,47680,143,1090,48913,27176,76089,M. David DOLUI,DVG,308,0.4,0.65,Battu
68,05,47680,143,1090,48913,27176,76089,M. Salah KELTOUMI,EXG,287,0.38,0.6,Battu
68,05,47680,143,1090,48913,27176,76089,M. Romain SPINALI,REG,249,0.33,0.52,Battu
68,06,58490,337,1139,59966,33895,93861,Mme Christelle RITZ,RN,23246,24.77,39.74,Qualif
68,06,58490,337,1139,59966,33895,93861,M. Bruno FUCHS,ENS,17660,18.82,30.19,Qualif
68,06,58490,337,1139,59966,33895,93861,Mme Florence CLAUDEPIERRE,UG,12913,13.76,22.08,Qualif
68,06,58490,337,1139,59966,33895,93861,M. Laurent ROTH,REG,1898,2.02,3.24,Battu
68,06,58490,337,1139,59966,33895,93861,M. Pascal BLUM,ECO,808,0.86,1.38,Battu
68,06,58490,337,1139,59966,33895,93861,M. Denis PINT,REC,711,0.76,1.22,Battu
68,06,58490,337,1139,59966,33895,93861,M. Romuald LOURENÇO,DSV,666,0.71,1.14,Battu
68,06,58490,337,1139,59966,33895,93861,Mme Nathalie MULOT,EXG,503,0.54,0.86,Battu
68,06,58490,337,1139,59966,33895,93861,M. Pablo ROLDAN-SANCHEZ,DVD,85,0.09,0.15,Battu
69,01,52592,201,511,53304,18613,71917,Mme Anaïs BELOUASSA-CHERIFI,UG,22300,31.01,42.4,Qualif
69,01,52592,201,511,53304,18613,71917,M. Thomas RUDIGOZ,ENS,15631,21.73,29.72,Qualif
69,01,52592,201,511,53304,18613,71917,M. Laurent MOUTON,RN,9521,13.24,18.1,Qualif
69,01,52592,201,511,53304,18613,71917,M. Grégory SANSOZ,LR,3070,4.27,5.84,Battu
69,01,52592,201,511,53304,18613,71917,Mme Anne THIRIAT,ECO,1176,1.64,2.24,Battu
69,01,52592,201,511,53304,18613,71917,M. Brandon ALVES,REC,424,0.59,0.81,Battu
69,01,52592,201,511,53304,18613,71917,M. Jim BUGNI,EXG,358,0.5,0.68,Battu
69,01,52592,201,511,53304,18613,71917,M. Guillaume EYMERIC,DIV,110,0.15,0.21,Battu
69,01,52592,201,511,53304,18613,71917,Mme Ivanka LOPOUCHANSKY,EXG,2,0,0,Battu
69,02,57534,189,427,58150,16461,74611,M. Boris TAVERNIER,UG,28567,38.29,49.65,Qualif
69,02,57534,189,427,58150,16461,74611,M. Loïc TERRENES,ENS,14455,19.37,25.12,Qualif
69,02,57534,189,427,58150,16461,74611,Mme Anaëlle BISLEAU,RN,8228,11.03,14.3,Battu
69,02,57534,189,427,58150,16461,74611,Mme Maryll GUILLOTEAU,LR,4456,5.97,7.74,Battu
69,02,57534,189,427,58150,16461,74611,M. Karim MAHMOUD-VINTAM,DIV,731,0.98,1.27,Battu
69,02,57534,189,427,58150,16461,74611,Mme Vanessa ETENNE,REC,456,0.61,0.79,Battu
69,02,57534,189,427,58150,16461,74611,Mme Delphine BRIDAY,EXG,297,0.4,0.52,Battu
69,02,57534,189,427,58150,16461,74611,M. Pascal COULAN,DIV,148,0.2,0.26,Battu
69,02,57534,189,427,58150,16461,74611,M. Michaël JOUTEUX,EXG,133,0.18,0.23,Battu
69,02,57534,189,427,58150,16461,74611,M. Nizar TOUIHRI,DIV,63,0.08,0.11,Battu
69,02,57534,189,427,58150,16461,74611,M. Anthony BRUNO,EXG,0,0,0,Battu
69,03,53842,172,426,54440,16382,70822,Mme Marie-Charlotte GARIN,UG,27736,39.16,51.51,Elu
69,03,53842,172,426,54440,16382,70822,Mme Clara EYNAUD-LASSALLE,ENS,11557,16.32,21.46,Battu
69,03,53842,172,426,54440,16382,70822,Mme Clotilde MORIN,RN,7938,11.21,14.74,Battu
69,03,53842,172,426,54440,16382,70822,Mme Béatrice DE MONTILLE,LR,4464,6.3,8.29,Battu
69,03,53842,172,426,54440,16382,70822,M. Éric LAFOND,ECO,688,0.97,1.28,Battu
69,03,53842,172,426,54440,16382,70822,M. Leo BOURRET,UDI,501,0.71,0.93,Battu
69,03,53842,172,426,54440,16382,70822,Mme Marie RILLY,REC,486,0.69,0.9,Battu
69,03,53842,172,426,54440,16382,70822,M. Jean-Noël DUDUKDJIAN,EXG,260,0.37,0.48,Battu
69,03,53842,172,426,54440,16382,70822,Mme Anaïs BARRALLON,EXG,141,0.2,0.26,Battu
69,03,53842,172,426,54440,16382,70822,M. Marc CHINAL,DIV,71,0.1,0.13,Battu
69,04,60411,152,517,61080,17818,78898,Mme Sandrine RUNEL,UG,22959,29.1,38,Qualif
69,04,60411,152,517,61080,17818,78898,Mme Anne BRUGNERA,ENS,18744,23.76,31.03,Qualif
69,04,60411,152,517,61080,17818,78898,M. Yannick CHAUMONT,RN,10818,13.71,17.91,Qualif
69,04,60411,152,517,61080,17818,78898,M. Romain BILLARD,LR,6267,7.94,10.37,Battu
69,04,60411,152,517,61080,17818,78898,Mme Armande TORRENT,REC,655,0.83,1.08,Battu
69,04,60411,152,517,61080,17818,78898,M. Julien QUEVY,ECO,496,0.63,0.82,Battu
69,04,60411,152,517,61080,17818,78898,Mme Coralie LAURENT,EXG,329,0.42,0.54,Battu
69,04,60411,152,517,61080,17818,78898,Mme Juliette VEL,DIV,143,0.18,0.24,Battu
69,04,60411,152,517,61080,17818,78898,M. Tristan JEGO,EXG,0,0,0,Battu
69,05,67326,208,696,68230,22377,90607,Mme Blandine BROCARD,ENS,21552,23.79,32.01,Qualif
69,05,67326,208,696,68230,22377,90607,M. Fabrice MATTEUCCI,UG,17831,19.68,26.48,Qualif
69,05,67326,208,696,68230,22377,90607,Mme Sasha BITOUM,RN,17090,18.86,25.38,Qualif
69,05,67326,208,696,68230,22377,90607,M. Bastien JOINT,LR,9431,10.41,14.01,Battu
69,05,67326,208,696,68230,22377,90607,M. Mathieu BAZIN,REC,1009,1.11,1.5,Battu
69,05,67326,208,696,68230,22377,90607,Mme Hélène RIVIERE,EXG,413,0.46,0.61,Battu
69,06,58963,240,768,59971,32037,92008,M. Gabriel AMARD,UG,27294,29.66,46.29,Qualif
69,06,58963,240,768,59971,32037,92008,M. Jean-Paul BRET,DVG,11755,12.78,19.94,Qualif
69,06,58963,240,768,59971,32037,92008,Mme Délia AGUS,RN,11167,12.14,18.94,Battu
69,06,58963,240,768,59971,32037,92008,M. Marc FRAYSSE,LR,7247,7.88,12.29,Battu
69,06,58963,240,768,59971,32037,92008,M. Joseph BASILIEN,ECO,723,0.79,1.23,Battu
69,06,58963,240,768,59971,32037,92008,Mme Nadia BOUHAMI,EXG,466,0.51,0.79,Battu
69,06,58963,240,768,59971,32037,92008,Mme Raphaëlle MIZONY,EXG,184,0.2,0.31,Battu
69,06,58963,240,768,59971,32037,92008,M. Teyi Kekeli LAWSON DOUTE,DIV,127,0.14,0.22,Battu
69,07,43614,249,527,44390,28217,72607,M. Abdelkader LAHMAR,UG,20062,27.63,46,Qualif
69,07,43614,249,527,44390,28217,72607,M. Alexandre VINCENDET,ENS,11799,16.25,27.05,Qualif
69,07,43614,249,527,44390,28217,72607,M. Cédric PIGNAL,RN,9280,12.78,21.28,Qualif
69,07,43614,249,527,44390,28217,72607,Mme Myriam FONTAINE,LR,1536,2.12,3.52,Battu
69,07,43614,249,527,44390,28217,72607,M. Thomas SPREUX,EXG,526,0.72,1.21,Battu
69,07,43614,249,527,44390,28217,72607,Mme Régine BENON,REC,411,0.57,0.94,Battu
69,08,77141,371,1101,78613,27394,106007,M. Jonathan GERY,RN,25808,24.35,33.46,Qualif
69,08,77141,371,1101,78613,27394,106007,Mme Anne REYMBAUT,UG,17548,16.55,22.75,Qualif
69,08,77141,371,1101,78613,27394,106007,M. Dominique DESPRAS,ENS,16338,15.41,21.18,Qualif
69,08,77141,371,1101,78613,27394,106007,Mme Nathalie SERRE,LR,15941,15.04,20.66,Qualif
69,08,77141,371,1101,78613,27394,106007,M. Xavier FOURBOUL,REC,876,0.83,1.14,Battu
69,08,77141,371,1101,78613,27394,106007,M. Tristan TEYSSIER,EXG,630,0.59,0.82,Battu
69,09,69096,274,973,70343,27780,98123,M. Patrick LOUIS,UXD,24464,24.93,35.41,Qualif
69,09,69096,274,973,70343,27780,98123,M. Alexandre PORTIER,LR,17554,17.89,25.41,Qualif
69,09,69096,274,973,70343,27780,98123,M. Jean-Henri SOUMIREU-LARTIGUE,UG,16066,16.37,23.25,Qualif
69,09,69096,274,973,70343,27780,98123,M. Antoine LAURENT,ENS,9935,10.13,14.38,Battu
69,09,69096,274,973,70343,27780,98123,M. Damien D'AUTRYVE,REG,613,0.62,0.89,Battu
69,09,69096,274,973,70343,27780,98123,Mme Chantal HELLY,EXG,464,0.47,0.67,Battu
69,10,73640,298,990,74928,24116,99044,M. Thomas GASSILLOUD,ENS,23963,24.19,32.54,Qualif
69,10,73640,298,990,74928,24116,99044,Mme Cecile PATOUT,RN,22941,23.16,31.15,Qualif
69,10,73640,298,990,74928,24116,99044,Mme Florence Janine Jacqueline PERRIN,UG,17412,17.58,23.64,Qualif
69,10,73640,298,990,74928,24116,99044,Mme Sophie CRUZ,LR,6689,6.75,9.08,Battu
69,10,73640,298,990,74928,24116,99044,M. David HORNUS,DVD,1296,1.31,1.76,Battu
69,10,73640,298,990,74928,24116,99044,Mme Irène BERENYI GELEY,REC,788,0.8,1.07,Battu
69,10,73640,298,990,74928,24116,99044,M. Gilles BOMPARD,EXG,551,0.56,0.75,Battu
69,11,68931,403,1100,70434,27586,98020,M. Alexandre HUMBERT DUPALAIS,UXD,25371,25.88,36.81,Qualif
69,11,68931,403,1100,70434,27586,98020,M. Jean-Luc FUGIT,ENS,18564,18.94,26.93,Qualif
69,11,68931,403,1100,70434,27586,98020,M. Abdel YOUSFI,UG,15765,16.08,22.87,Qualif
69,11,68931,403,1100,70434,27586,98020,Mme Cindy FERRO,LR,6707,6.84,9.73,Battu
69,11,68931,403,1100,70434,27586,98020,Mme Sophie SPENNATO,ECO,1974,2.01,2.86,Battu
69,11,68931,403,1100,70434,27586,98020,Mme Isabelle BROWNING,EXG,550,0.56,0.8,Battu
69,12,60105,230,613,60948,21799,82747,Mme Lucie GAILLOT DURAND,UG,18044,21.81,30.02,Qualif
69,12,60105,230,613,60948,21799,82747,M. Cyrille ISAAC-SIBILLE,ENS,17411,21.04,28.97,Qualif
69,12,60105,230,613,60948,21799,82747,Mme Clémence LUISIER,RN,15003,18.13,24.96,Qualif
69,12,60105,230,613,60948,21799,82747,M. Pascal CHARMOT,LR,8345,10.08,13.88,Battu
69,12,60105,230,613,60948,21799,82747,Mme Noémie GALLICE,REC,737,0.89,1.23,Battu
69,12,60105,230,613,60948,21799,82747,Mme Cécile FAURITE,EXG,565,0.68,0.94,Battu
69,13,61671,280,751,62702,27099,89801,Mme Tiffany JONCOUR,RN,22417,24.96,36.35,Qualif
69,13,61671,280,751,62702,27099,89801,M. Victor PRANDT,UG,16178,18.02,26.23,Qualif
69,13,61671,280,751,62702,27099,89801,Mme Sarah TANZILLI,ENS,14933,16.63,24.21,Qualif
69,13,61671,280,751,62702,27099,89801,M. Philippe MEUNIER,LR,6106,6.8,9.9,Battu
69,13,61671,280,751,62702,27099,89801,M. Didier BARTHÈS,DVG,799,0.89,1.3,Battu
69,13,61671,280,751,62702,27099,89801,Mme Océane GIGAREL,REC,610,0.68,0.99,Battu
69,13,61671,280,751,62702,27099,89801,M. Michel PIOT,EXG,523,0.58,0.85,Battu
69,13,61671,280,751,62702,27099,89801,M. Patrick BIAUT,DVD,105,0.12,0.17,Battu
69,14,44798,339,654,45791,30781,76572,M. Idir BOUMERTIT,UG,21854,28.54,48.78,Qualif
69,14,44798,339,654,45791,30781,76572,M. Cédric MERMET,RN,12637,16.5,28.21,Qualif
69,14,44798,339,654,45791,30781,76572,M. Ludovic ALMERAS,ENS,6996,9.14,15.62,Battu
69,14,44798,339,654,45791,30781,76572,M. David MAZZONE,LR,2059,2.69,4.6,Battu
69,14,44798,339,654,45791,30781,76572,M. Olivier MINOUX,EXG,815,1.06,1.82,Battu
69,14,44798,339,654,45791,30781,76572,Mme Blandine RIHA,REC,437,0.57,0.98,Battu
70,01,60336,947,1227,62510,25845,88355,M. Antoine VILLEDIEU,RN,29458,33.34,48.82,Qualif
70,01,60336,947,1227,62510,25845,88355,M. Alain CHRETIEN,ENS,18093,20.48,29.99,Qualif
70,01,60336,947,1227,62510,25845,88355,M. Sébastien POYARD,UG,10362,11.73,17.17,Battu
70,01,60336,947,1227,62510,25845,88355,M. Mohamed-Salah ZELFA,DIV,906,1.03,1.5,Battu
70,01,60336,947,1227,62510,25845,88355,M. Cédric FISCHER,EXG,816,0.92,1.35,Battu
70,01,60336,947,1227,62510,25845,88355,M. Philippe GHILES,REC,701,0.79,1.16,Battu
70,02,60498,1082,1201,62781,26597,89378,M. Emeric SALMON,RN,30315,33.92,50.11,Elu
70,02,60498,1082,1201,62781,26597,89378,M. Eric HOULLEY,UG,13632,15.25,22.53,Battu
70,02,60498,1082,1201,62781,26597,89378,M. Fabrice BARASSI-ZAMOCHNIKOFF,ENS,8354,9.35,13.81,Battu
70,02,60498,1082,1201,62781,26597,89378,M. Loic LABORIE,LR,6600,7.38,10.91,Battu
70,02,60498,1082,1201,62781,26597,89378,Mme Isabelle APRO,EXG,1018,1.14,1.68,Battu
70,02,60498,1082,1201,62781,26597,89378,M. Christophe DEVILLERS,REC,579,0.65,0.96,Battu
71,01,50798,444,934,52176,23084,75260,Mme Rachel DREVET,RN,17602,23.39,34.65,Qualif
71,01,50798,444,934,52176,23084,75260,M. Benjamin DIRX,ENS,15546,20.66,30.6,Qualif
71,01,50798,444,934,52176,23084,75260,M. Jean-Luc DELPEUCH,UG,14017,18.62,27.59,Qualif
71,01,50798,444,934,52176,23084,75260,M. Jean-Philippe BELVILLE,LR,2368,3.15,4.66,Battu
71,01,50798,444,934,52176,23084,75260,M. Jean-Armand ROY,DSV,836,1.11,1.65,Battu
71,01,50798,444,934,52176,23084,75260,M. Christophe SPRINGAUX,EXG,429,0.57,0.84,Battu
71,02,52144,532,894,53570,23051,76621,M. Olivier DAMIEN,RN,19738,25.76,37.85,Qualif
71,02,52144,532,894,53570,23051,76621,Mme Josiane CORNELOUP,LR,17511,22.85,33.58,Qualif
71,02,52144,532,894,53570,23051,76621,M. Sébastien GAUTHERON,UG,9124,11.91,17.5,Battu
71,02,52144,532,894,53570,23051,76621,M. Raymond ZEKPA,ENS,5094,6.65,9.77,Battu
71,02,52144,532,894,53570,23051,76621,M. Patrick BERTHELOT,EXG,677,0.88,1.3,Battu
71,03,54201,733,1232,56166,24735,80901,M. Aurélien DUTREMBLE,RN,23130,28.59,42.67,Qualif
71,03,54201,733,1232,56166,24735,80901,M. Rémy REBEYROTTE,ENS,13606,16.82,25.1,Qualif
71,03,54201,733,1232,56166,24735,80901,M. Richard BENINGER,UG,10375,12.82,19.14,Qualif
71,03,54201,733,1232,56166,24735,80901,M. Charles LANDRE,DVD,5384,6.66,9.93,Battu
71,03,54201,733,1232,56166,24735,80901,Mme France ROBERT,DSV,783,0.97,1.44,Battu
71,03,54201,733,1232,56166,24735,80901,Mme Julie LUCOTTE,EXG,730,0.9,1.35,Battu
71,03,54201,733,1232,56166,24735,80901,M. José Antonio GRANADO,DIV,193,0.24,0.36,Battu
71,04,54744,587,1299,56630,25995,82625,M. Eric MICHOUX,UXD,24276,29.38,44.34,Qualif
71,04,54744,587,1299,56630,25995,82625,Mme Cécile UNTERMAIER,UG,16403,19.85,29.96,Qualif
71,04,54744,587,1299,56630,25995,82625,M. Anthony VADOT,LR,12222,14.79,22.33,Qualif
71,04,54744,587,1299,56630,25995,82625,M. Claude COURATIER,EXG,1115,1.35,2.04,Battu
71,04,54744,587,1299,56630,25995,82625,Mme Véronique BELLEST,DSV,728,0.88,1.33,Battu
71,05,56392,573,945,57910,28033,85943,M. Arnaud SANVERT,RN,19807,23.05,35.12,Qualif
71,05,56392,573,945,57910,28033,85943,Mme Fatima KOURICHE,UG,13130,15.28,23.28,Qualif
71,05,56392,573,945,57910,28033,85943,M. Louis MARGUERITTE,ENS,11699,13.61,20.75,Qualif
71,05,56392,573,945,57910,28033,85943,M. Gilles PLATRET,DVD,10746,12.5,19.06,Qualif
71,05,56392,573,945,57910,28033,85943,M. Pascal DUFRAIGNE,EXG,885,1.03,1.57,Battu
71,05,56392,573,945,57910,28033,85943,M. Alain CADIOT,DVD,125,0.15,0.22,Battu
72,01,49003,419,1213,50635,23131,73766,Mme Céline DE COSSÉ BRISSAC,RN,16465,22.32,33.6,Qualif
72,01,49003,419,1213,50635,23131,73766,Mme Julie DELPECH,ENS,15111,20.49,30.84,Qualif
72,01,49003,419,1213,50635,23131,73766,Mme Ghislaine BONNET,UG,12258,16.62,25.01,Qualif
72,01,49003,419,1213,50635,23131,73766,M. Clément COULON,LR,4459,6.04,9.1,Battu
72,01,49003,419,1213,50635,23131,73766,Mme Sylvie MAILLET,EXG,710,0.96,1.45,Battu
72,02,51811,322,1510,53643,30121,83764,Mme Marietta KARAMANLI,UG,20700,24.71,39.95,Qualif
72,02,51811,322,1510,53643,30121,83764,M. François FEVRE,UXD,18282,21.83,35.29,Qualif
72,02,51811,322,1510,53643,30121,83764,M. Samuel CHEVALLIER,UDI,11962,14.28,23.09,Qualif
72,02,51811,322,1510,53643,30121,83764,M. Thomas HUBERT,EXG,776,0.93,1.5,Battu
72,02,51811,322,1510,53643,30121,83764,M. Clément CHEURET,DIV,91,0.11,0.18,Battu
72,03,55559,647,1317,57523,28355,85878,M. Romain LEMOIGNE,RN,23637,27.52,42.54,Qualif
72,03,55559,647,1317,57523,28355,85878,M. Eric MARTINEAU,ENS,16209,18.87,29.17,Qualif
72,03,55559,647,1317,57523,28355,85878,Mme Mathilde JACK,UG,10320,12.02,18.57,Battu
72,03,55559,647,1317,57523,28355,85878,M. Vincent GRUAU,LR,2819,3.28,5.07,Battu
72,03,55559,647,1317,57523,28355,85878,M. Raymond DE MALHERBE,REC,1131,1.32,2.04,Battu
72,03,55559,647,1317,57523,28355,85878,Mme Maryse BRUTOUT,EXG,885,1.03,1.59,Battu
72,03,55559,647,1317,57523,28355,85878,M. Éric TROCHON,DSV,558,0.65,1,Battu
72,04,52424,472,1247,54143,27296,81439,Mme Marie-Caroline LE PEN,RN,20584,25.28,39.26,Qualif
72,04,52424,472,1247,54143,27296,81439,Mme Elise LEBOUCHER,UG,13600,16.7,25.94,Qualif
72,04,52424,472,1247,54143,27296,81439,Mme Sylvie CASENAVE-PÉRÉ,ENS,13565,16.66,25.88,Qualif
72,04,52424,472,1247,54143,27296,81439,M. Léo BRISARD,LR,2316,2.84,4.42,Battu
72,04,52424,472,1247,54143,27296,81439,M. Didier BARBET,DVD,1546,1.9,2.95,Battu
72,04,52424,472,1247,54143,27296,81439,M. Thierry NOUCHY,EXG,596,0.73,1.14,Battu
72,04,52424,472,1247,54143,27296,81439,M. Jean-Michel BRUGADE,REG,217,0.27,0.41,Battu
72,05,57213,497,1367,59077,28903,87980,M. Pierre VAUGARNY,RN,21870,24.86,38.23,Qualif
72,05,57213,497,1367,59077,28903,87980,M. Jean-Carles GRELIER,ENS,17898,20.34,31.28,Qualif
72,05,57213,497,1367,59077,28903,87980,M. Christophe ROUILLON,UG,15261,17.35,26.67,Qualif
72,05,57213,497,1367,59077,28903,87980,Mme Cécile BAYLE DE JESSÉ,DSV,1285,1.46,2.25,Battu
72,05,57213,497,1367,59077,28903,87980,Mme Karine FOUQUET,EXG,899,1.02,1.57,Battu
73,01,66348,585,1130,68063,26053,94116,Mme Typhanie DEGOIS,UXD,23992,25.49,36.16,Qualif
73,01,66348,585,1130,68063,26053,94116,Mme Marina FERRARI,ENS,23381,24.84,35.24,Qualif
73,01,66348,585,1130,68063,26053,94116,Mme Christel GRANATA,UG,15212,16.16,22.93,Qualif
73,01,66348,585,1130,68063,26053,94116,M. Frédéric EXERTIER,ECO,2292,2.44,3.45,Battu
73,01,66348,585,1130,68063,26053,94116,M. Guy-Alain PEYRARD,REC,828,0.88,1.25,Battu
73,01,66348,585,1130,68063,26053,94116,M. Adrien CASEJUANE,EXG,450,0.48,0.68,Battu
73,01,66348,585,1130,68063,26053,94116,M. Jean-Pierre CHAUVEAU,DSV,193,0.21,0.29,Battu
73,02,50469,385,746,51600,24026,75626,M. Vincent ROLLAND,LR,18593,24.59,36.84,Qualif
73,02,50469,385,746,51600,24026,75626,Mme Pauline RACT-BRANCAZ,RN,17762,23.49,35.19,Qualif
73,02,50469,385,746,51600,24026,75626,Mme Pascale MARTINOT,UG,11591,15.33,22.97,Qualif
73,02,50469,385,746,51600,24026,75626,Mme Delphine JAFFRÉ,REG,1244,1.64,2.46,Battu
73,02,50469,385,746,51600,24026,75626,M. Mathieu CICERI,DSV,488,0.65,0.97,Battu
73,02,50469,385,746,51600,24026,75626,Mme Morgane BETTOLI,REC,441,0.58,0.87,Battu
73,02,50469,385,746,51600,24026,75626,Mme Myriam RAHALIA,EXG,350,0.46,0.69,Battu
73,03,52877,355,821,54053,20530,74583,Mme Emilie BONNIVARD,LR,21605,28.97,40.86,Qualif
73,03,52877,355,821,54053,20530,74583,Mme Marie DAUCHY,RN,19023,25.51,35.98,Qualif
73,03,52877,355,821,54053,20530,74583,M. Daniel IBANEZ,UG,11530,15.46,21.81,Qualif
73,03,52877,355,821,54053,20530,74583,Mme Pascale TROUVÉ,EXG,719,0.96,1.36,Battu
73,04,55044,426,1148,56618,22994,79612,M. Jean-François COULOMME,UG,20297,25.49,36.87,Qualif
73,04,55044,426,1148,56618,22994,79612,M. Brice BERNARD,RN,16642,20.9,30.23,Qualif
73,04,55044,426,1148,56618,22994,79612,Mme Anaïs GOMERO,ENS,15256,19.16,27.72,Qualif
73,04,55044,426,1148,56618,22994,79612,M. Albin GUILLAUD,DIV,1188,1.49,2.16,Battu
73,04,55044,426,1148,56618,22994,79612,M. Vincent THOMAZO,DSV,1016,1.28,1.85,Battu
73,04,55044,426,1148,56618,22994,79612,Mme Marie DUCRUET,EXG,643,0.81,1.17,Battu
73,04,55044,426,1148,56618,22994,79612,M. Vincent BERNOLLIN,UDI,2,0,0,Battu
74,01,78796,529,1570,80895,29789,110684,Mme Véronique RIOTTON,ENS,28079,25.37,35.64,Qualif
74,01,78796,529,1570,80895,29789,110684,M. Guillaume ROIT-LEVÊQUE,RN,24500,22.14,31.09,Qualif
74,01,78796,529,1570,80895,29789,110684,Mme Anne-Valérie DUVAL,UG,17980,16.24,22.82,Qualif
74,01,78796,529,1570,80895,29789,110684,M. Florian THABUIS,LR,6527,5.9,8.28,Battu
74,01,78796,529,1570,80895,29789,110684,Mme Claudine MOLIN,REC,937,0.85,1.19,Battu
74,01,78796,529,1570,80895,29789,110684,M. Jacques MATTEI,EXG,675,0.61,0.86,Battu
74,01,78796,529,1570,80895,29789,110684,M. Stéphane ESPIC,DIV,98,0.09,0.12,Battu
74,02,71476,362,1219,73057,28636,101693,M. Antoine ARMAND,ENS,23783,23.39,33.27,Qualif
74,02,71476,362,1219,73057,28636,101693,M. Anis BOUVARD,RN,20583,20.24,28.8,Qualif
74,02,71476,362,1219,73057,28636,101693,M. Guillaume TATU,UG,19215,18.9,26.88,Qualif
74,02,71476,362,1219,73057,28636,101693,M. Alexandre RICHEFORT,LR,5396,5.31,7.55,Battu
74,02,71476,362,1219,73057,28636,101693,M. Jérémy LANGLADE-NOUCHY,REG,1077,1.06,1.51,Battu
74,02,71476,362,1219,73057,28636,101693,Mme Pascale VINCENT,REC,872,0.86,1.22,Battu
74,02,71476,362,1219,73057,28636,101693,M. Naci YILDIRIM,EXG,411,0.4,0.58,Battu
74,02,71476,362,1219,73057,28636,101693,M. Geoffrey CORNET,EXG,139,0.14,0.19,Battu
74,03,60936,326,1157,62419,27529,89948,M. Antoine VALENTIN,UXD,24182,26.88,39.68,Qualif
74,03,60936,326,1157,62419,27529,89948,Mme Christelle PETEX,DVD,19726,21.93,32.37,Qualif
74,03,60936,326,1157,62419,27529,89948,M. Gérard VEZ,UG,14630,16.26,24.01,Qualif
74,03,60936,326,1157,62419,27529,89948,Mme Véronique BOUVIER,REG,1742,1.94,2.86,Battu
74,03,60936,326,1157,62419,27529,89948,Mme Jocelyne LEGOUHY,EXG,656,0.73,1.08,Battu
74,04,56019,211,639,56869,34056,90925,Mme Virginie DUBY-MULLER,LR,20865,22.95,37.25,Qualif
74,04,56019,211,639,56869,34056,90925,Mme Magalie LUHO,RN,16159,17.77,28.85,Qualif
74,04,56019,211,639,56869,34056,90925,Mme Dominique LACHENAL,UG,15331,16.86,27.37,Qualif
74,04,56019,211,639,56869,34056,90925,M. Alexandre GIANESELLO,DVC,2265,2.49,4.04,Battu
74,04,56019,211,639,56869,34056,90925,Mme Barbara LEMMO GAUD,REG,945,1.04,1.69,Battu
74,04,56019,211,639,56869,34056,90925,Mme Cécile ROCHE,EXG,371,0.41,0.66,Battu
74,04,56019,211,639,56869,34056,90925,M. Jean-Marc LORENZO,DIV,83,0.09,0.15,Battu
74,05,67973,416,1183,69572,34132,103704,M. Quentin TAÏEB,UXD,21822,21.04,32.1,Qualif
74,05,67973,416,1183,69572,34132,103704,Mme Anne-Cécile VIOLLAND,ENS,21124,20.37,31.08,Qualif
74,05,67973,416,1183,69572,34132,103704,M. Jean-Baptiste BAUD,UG,15985,15.41,23.52,Qualif
74,05,67973,416,1183,69572,34132,103704,Mme Chrystelle BEURRIER,DVD,4800,4.63,7.06,Battu
74,05,67973,416,1183,69572,34132,103704,M. Daniel MAGNIN,REG,1808,1.74,2.66,Battu
74,05,67973,416,1183,69572,34132,103704,M. Nicolas BAL,REG,987,0.95,1.45,Battu
74,05,67973,416,1183,69572,34132,103704,M. Sacha POIDEVIN,REC,963,0.93,1.42,Battu
74,05,67973,416,1183,69572,34132,103704,Mme Michelle BALLY,EXG,484,0.47,0.71,Battu
74,06,54232,289,904,55425,26733,82158,M. Charles PRATS,UXD,19639,23.9,36.21,Qualif
74,06,54232,289,904,55425,26733,82158,M. Xavier ROSEREN,ENS,18805,22.89,34.68,Qualif
74,06,54232,289,904,55425,26733,82158,M. Alain ROUBIAN,UG,12039,14.65,22.2,Qualif
74,06,54232,289,904,55425,26733,82158,M. Cyrille DU PELOUX,LR,3135,3.82,5.78,Battu
74,06,54232,289,904,55425,26733,82158,M. Alexandre DEMEURE,EXG,614,0.75,1.13,Battu
75,01,62753,173,495,63421,20888,84309,M. Sylvain MAILLARD,ENS,28048,33.27,44.7,Qualif
75,01,62753,173,495,63421,20888,84309,M. Raphaël KEMPF,UG,20138,23.89,32.09,Qualif
75,01,62753,173,495,63421,20888,84309,Mme Delphine VOIRIN,RN,6303,7.48,10.04,Battu
75,01,62753,173,495,63421,20888,84309,Mme Laurence SAILLIET,LR,3469,4.11,5.53,Battu
75,01,62753,173,495,63421,20888,84309,M. Pierre MAURIN,DVD,2883,3.42,4.59,Battu
75,01,62753,173,495,63421,20888,84309,Mme Marine CHIABERTO,REC,991,1.18,1.58,Battu
75,01,62753,173,495,63421,20888,84309,M. Alban Ludovic Bertrand PINEAU,DVC,598,0.71,0.95,Battu
75,01,62753,173,495,63421,20888,84309,Mme Laurence BOULINIER,EXG,231,0.27,0.37,Battu
75,01,62753,173,495,63421,20888,84309,Mme Mathilde CONTENSOU,REG,89,0.11,0.14,Battu
75,01,62753,173,495,63421,20888,84309,M. Axel METZKER,DIV,3,0,0,Battu
75,01,62753,173,495,63421,20888,84309,M. Aurélien GAUTREAU,EXG,0,0,0,Battu
75,02,56418,153,337,56908,17671,74579,Mme Marine ROSSET,UG,18845,25.27,33.4,Qualif
75,02,56418,153,337,56908,17671,74579,M. Jean LAUSSUCQ,ENS,13325,17.87,23.62,Qualif
75,02,56418,153,337,56908,17671,74579,M. Gilles LE GENDRE,DVC,11071,14.84,19.62,Qualif
75,02,56418,153,337,56908,17671,74579,Mme Melody DE WITTE,RN,6206,8.32,11,Battu
75,02,56418,153,337,56908,17671,74579,Mme Félicité HERZOG DE COSSÉ BRISSAC,DVD,3792,5.08,6.72,Battu
75,02,56418,153,337,56908,17671,74579,M. Romain MARSILY,DVD,1229,1.65,2.18,Battu
75,02,56418,153,337,56908,17671,74579,Mme Ornella EVANGELISTA,REC,778,1.04,1.38,Battu
75,02,56418,153,337,56908,17671,74579,Mme Cécile Marie LORANS,ECO,512,0.69,0.91,Battu
75,02,56418,153,337,56908,17671,74579,M. Frédéric MAURIANGE,DVC,430,0.58,0.76,Battu
75,02,56418,153,337,56908,17671,74579,Mme Charline JOLIVEAU,EXG,168,0.23,0.3,Battu
75,02,56418,153,337,56908,17671,74579,Mme Elise MAGNE,DVG,60,0.08,0.11,Battu
75,02,56418,153,337,56908,17671,74579,Mme Clara SACASA,EXG,0,0,0,Battu
75,03,52962,236,464,53662,19516,73178,Mme Léa BALAGE EL MARIKY,UG,24441,33.4,46.15,Qualif
75,03,52962,236,464,53662,19516,73178,M. Stanislas GUERINI,ENS,18001,24.6,33.99,Qualif
75,03,52962,236,464,53662,19516,73178,Mme Olga PODOLSKAIA,RN,4709,6.43,8.89,Battu
75,03,52962,236,464,53662,19516,73178,M. Paul HATTE,LR,4118,5.63,7.78,Battu
75,03,52962,236,464,53662,19516,73178,Mme Marie COURTOIS,REC,486,0.66,0.92,Battu
75,03,52962,236,464,53662,19516,73178,M. Côme CITROEN,ECO,433,0.59,0.82,Battu
75,03,52962,236,464,53662,19516,73178,M. Laurent BURTAIRE,EXG,232,0.32,0.44,Battu
75,03,52962,236,464,53662,19516,73178,M. Grégory FERNANDES,EXG,151,0.21,0.29,Battu
75,03,52962,236,464,53662,19516,73178,M. Quentin LAPORTE,DVC,116,0.16,0.22,Battu
75,03,52962,236,464,53662,19516,73178,Mme Warda BAÏLICHE,DVC,102,0.14,0.19,Battu
75,03,52962,236,464,53662,19516,73178,M. Laurent SEMAT,DVG,92,0.13,0.17,Battu
75,03,52962,236,464,53662,19516,73178,M. Thierry ALQUIER,DVD,81,0.11,0.15,Battu
75,03,52962,236,464,53662,19516,73178,Mme Irène GASARIAN,EXG,0,0,0,Battu
75,04,52905,153,313,53371,19833,73204,Mme Astrid PANOSYAN-BOUVET,ENS,19677,26.88,37.19,Qualif
75,04,52905,153,313,53371,19833,73204,M. Geoffroy BOULARD,DVD,14048,19.19,26.55,Qualif
75,04,52905,153,313,53371,19833,73204,Mme Théa FOUDRINIER,UG,9474,12.94,17.91,Qualif
75,04,52905,153,313,53371,19833,73204,M. Arnaud DASSIER,UXD,8227,11.24,15.55,Battu
75,04,52905,153,313,53371,19833,73204,M. Olivier COURTOIS,REC,1135,1.55,2.15,Battu
75,04,52905,153,313,53371,19833,73204,M. Pierre LEVENARD,EXG,105,0.14,0.2,Battu
75,04,52905,153,313,53371,19833,73204,M. Karim BRITEL,DIV,99,0.14,0.19,Battu
75,04,52905,153,313,53371,19833,73204,Mme Laetitia LAURON,DVG,84,0.11,0.16,Battu
75,04,52905,153,313,53371,19833,73204,M. Guillaume CARDON,DIV,56,0.08,0.11,Battu
75,04,52905,153,313,53371,19833,73204,M. Emile MAHIEU,EXG,0,0,0,Battu
75,05,59281,187,400,59868,19583,79451,M. Pouria AMIRSHAHI,UG,32152,40.47,54.24,Elu
75,05,59281,187,400,59868,19583,79451,Mme Rachel-Flore PARDO,ENS,17879,22.5,30.16,Battu
75,05,59281,187,400,59868,19583,79451,Mme Céline CHEN,RN,4186,5.27,7.06,Battu
75,05,59281,187,400,59868,19583,79451,Mme Valentine SERINO,LR,2459,3.09,4.15,Battu
75,05,59281,187,400,59868,19583,79451,Mme Thiaba BRUNI,ECO,674,0.85,1.14,Battu
75,05,59281,187,400,59868,19583,79451,Mme Yoneko KIKUCHI,REC,534,0.67,0.9,Battu
75,05,59281,187,400,59868,19583,79451,M. Théo FAUCON,DVC,511,0.64,0.86,Battu
75,05,59281,187,400,59868,19583,79451,M. Arnaud BOROWSKI,ECO,367,0.46,0.62,Battu
75,05,59281,187,400,59868,19583,79451,Mme Monique DABAT,EXG,271,0.34,0.46,Battu
75,05,59281,187,400,59868,19583,79451,M. Raymond Victor BASSIL,DVC,133,0.17,0.22,Battu
75,05,59281,187,400,59868,19583,79451,Mme Anne CHAMAYOU,DVG,114,0.14,0.19,Battu
75,05,59281,187,400,59868,19583,79451,M. Léonard GUIOT,EXG,1,0,0,Battu
75,06,58997,355,642,59994,21243,81237,Mme Sophia CHIKIROU,UG,34329,42.26,58.19,Elu
75,06,58997,355,642,59994,21243,81237,Mme Gwënaelle COULON,ENS,13230,16.29,22.42,Battu
75,06,58997,355,642,59994,21243,81237,Mme Élise Maryse LAPLACE,RN,4301,5.29,7.29,Battu
75,06,58997,355,642,59994,21243,81237,M. Jean-Christophe MARTIN,LR,2317,2.85,3.93,Battu
75,06,58997,355,642,59994,21243,81237,M. Louis GUNDERMANN,DVC,1577,1.94,2.67,Battu
75,06,58997,355,642,59994,21243,81237,M. Hippolyte VERDIER,ECO,1208,1.49,2.05,Battu
75,06,58997,355,642,59994,21243,81237,Mme Amélie JULLIEN,REC,626,0.77,1.06,Battu
75,06,58997,355,642,59994,21243,81237,Mme Veronique BRUNET,EXG,509,0.63,0.86,Battu
75,06,58997,355,642,59994,21243,81237,M. Alain Jean AMOUNI,DIV,450,0.55,0.76,Battu
75,06,58997,355,642,59994,21243,81237,M. Thierry SESSIN CARACCI,DVG,377,0.46,0.64,Battu
75,06,58997,355,642,59994,21243,81237,Mme Dima LECREST,DVG,73,0.09,0.12,Battu
75,06,58997,355,642,59994,21243,81237,Mme Laurence NICOLAS,EXG,0,0,0,Battu
75,06,58997,355,642,59994,21243,81237,M. Martial MUTTE,DVG,0,0,0,Battu
75,07,60894,182,424,61500,18864,80364,M. Emmanuel GREGOIRE,UG,30974,38.54,50.87,Elu
75,07,60894,182,424,61500,18864,80364,M. Clément BEAUNE,ENS,19958,24.83,32.77,Battu
75,07,60894,182,424,61500,18864,80364,Mme Céline TACHER,RN,4815,5.99,7.91,Battu
75,07,60894,182,424,61500,18864,80364,M. Aurélien VÉRON,LR,3010,3.75,4.94,Battu
75,07,60894,182,424,61500,18864,80364,M. Jason REYES,REC,655,0.82,1.08,Battu
75,07,60894,182,424,61500,18864,80364,M. Philippe MAZUEL,DVC,596,0.74,0.98,Battu
75,07,60894,182,424,61500,18864,80364,Mme Sophie LACAZE,ECO,532,0.66,0.87,Battu
75,07,60894,182,424,61500,18864,80364,Mme Aurélia PETIT,EXG,289,0.36,0.47,Battu
75,07,60894,182,424,61500,18864,80364,Mme Anne GRAU,DVC,65,0.08,0.11,Battu
75,07,60894,182,424,61500,18864,80364,Mme Stéphanie BLANC,EXG,0,0,0,Battu
75,08,60962,280,625,61867,23430,85297,Mme Eva SAS,UG,30923,36.25,50.73,Elu
75,08,60962,280,625,61867,23430,85297,M. David OUZILOU,ENS,17305,20.29,28.39,Battu
75,08,60962,280,625,61867,23430,85297,Mme Vanessa VICENTE,RN,7084,8.31,11.62,Battu
75,08,60962,280,625,61867,23430,85297,M. Florent BRUNETTI,LR,3210,3.76,5.27,Battu
75,08,60962,280,625,61867,23430,85297,M. Pierre-Louis GISCARD D'ESTAING,DVC,960,1.13,1.57,Battu
75,08,60962,280,625,61867,23430,85297,M. Jannick TRUNKENWALD,REC,688,0.81,1.13,Battu
75,08,60962,280,625,61867,23430,85297,Mme Anne BERNON,EXG,317,0.37,0.52,Battu
75,08,60962,280,625,61867,23430,85297,Mme Christine VIAL KAYSER,DVC,280,0.33,0.46,Battu
75,08,60962,280,625,61867,23430,85297,Mme Camille ADOUE,EXG,176,0.21,0.29,Battu
75,08,60962,280,625,61867,23430,85297,M. Manuel LUTZ,REG,19,0.02,0.03,Battu
75,08,60962,280,625,61867,23430,85297,M. N'Cho Xavier LAWSON-AGBAN,DVG,0,0,0,Battu
75,08,60962,280,625,61867,23430,85297,M. Gwenolé SELLES,EXG,0,0,0,Battu
75,09,49913,263,570,50746,20586,71332,Mme Sandrine ROUSSEAU,UG,26020,36.48,52.13,Elu
75,09,49913,263,570,50746,20586,71332,Mme Pegah MALEK-AHMADI,ENS,11550,16.19,23.14,Battu
75,09,49913,263,570,50746,20586,71332,Mme Marie-Josée BOULAIRE,RN,5733,8.04,11.49,Battu
75,09,49913,263,570,50746,20586,71332,M. Jean-Baptiste OLIVIER,DVD,2290,3.21,4.59,Battu
75,09,49913,263,570,50746,20586,71332,Mme Elisabeth STIBBE,DVD,1495,2.1,3,Battu
75,09,49913,263,570,50746,20586,71332,Mme Jade FARRAN,DVC,678,0.95,1.36,Battu
75,09,49913,263,570,50746,20586,71332,Mme Marion BOTTOU,REC,611,0.86,1.22,Battu
75,09,49913,263,570,50746,20586,71332,M. Julian ROZENBERG,ECO,565,0.79,1.13,Battu
75,09,49913,263,570,50746,20586,71332,Mme Florence Jacqueline Chantal BEDAGUE,EXG,396,0.56,0.79,Battu
75,09,49913,263,570,50746,20586,71332,Mme Sophie CHEN,DVD,269,0.38,0.54,Battu
75,09,49913,263,570,50746,20586,71332,Mme Blandine CHAUVEL,EXG,251,0.35,0.5,Battu
75,09,49913,263,570,50746,20586,71332,M. Marc ELY,EXD,55,0.08,0.11,Battu
75,10,49777,255,451,50483,19923,70406,M. Rodrigo ARENAS,UG,25216,35.82,50.66,Elu
75,10,49777,255,451,50483,19923,70406,M. Benjamin DJIANE,ENS,11918,16.93,23.94,Battu
75,10,49777,255,451,50483,19923,70406,Mme Agnès PAGEARD,RN,5670,8.05,11.39,Battu
75,10,49777,255,451,50483,19923,70406,M. Patrick VIRY,LR,2965,4.21,5.96,Battu
75,10,49777,255,451,50483,19923,70406,M. Yann WEHRLING,ECO,1324,1.88,2.66,Battu
75,10,49777,255,451,50483,19923,70406,Mme Alexia OSTYN,DVC,640,0.91,1.29,Battu
75,10,49777,255,451,50483,19923,70406,M. Roger BERTHOLON,REC,634,0.9,1.27,Battu
75,10,49777,255,451,50483,19923,70406,Mme Charlotte DE VILMORIN,DIV,623,0.88,1.25,Battu
75,10,49777,255,451,50483,19923,70406,M. Michel GOLDSTEIN,DVC,469,0.67,0.94,Battu
75,10,49777,255,451,50483,19923,70406,Mme Marianne NOEL,EXG,318,0.45,0.64,Battu
75,10,49777,255,451,50483,19923,70406,Mme Camille LEBRUN,EXG,0,0,0,Battu
75,11,55368,162,451,55981,16891,72872,Mme Céline HERVIEU,UG,24195,33.2,43.7,Qualif
75,11,55368,162,451,55981,16891,72872,Mme Maud GATEL,ENS,19295,26.48,34.85,Qualif
75,11,55368,162,451,55981,16891,72872,Mme Lindsay FISCHER,RN,5632,7.73,10.17,Battu
75,11,55368,162,451,55981,16891,72872,M. Jean-François ALEXANDRE,LR,3888,5.34,7.02,Battu
75,11,55368,162,451,55981,16891,72872,Mme Anne-Marie TARANNE,REC,749,1.03,1.35,Battu
75,11,55368,162,451,55981,16891,72872,Mme Julie LASNE,ECO,715,0.98,1.29,Battu
75,11,55368,162,451,55981,16891,72872,M. Julien VICK,DVC,387,0.53,0.7,Battu
75,11,55368,162,451,55981,16891,72872,Mme Marie CAMP,DVC,259,0.36,0.47,Battu
75,11,55368,162,451,55981,16891,72872,M. Laurent VINCIGUERRA,EXG,223,0.31,0.4,Battu
75,11,55368,162,451,55981,16891,72872,M. Iwan CLEMENTE,DIV,25,0.03,0.05,Battu
75,11,55368,162,451,55981,16891,72872,Mme Rose LAVIRE,EXG,0,0,0,Battu
75,12,56268,186,406,56860,18655,75515,Mme Olivia GREGOIRE,ENS,22145,29.33,39.36,Qualif
75,12,56268,186,406,56860,18655,75515,Mme Celine MALAISÉ,UG,16294,21.58,28.96,Qualif
75,12,56268,186,406,56860,18655,75515,M. David ATTIA,UXD,8111,10.74,14.41,Battu
75,12,56268,186,406,56860,18655,75515,M. Jérôme LORIAU,LR,7297,9.66,12.97,Battu
75,12,56268,186,406,56860,18655,75515,M. Philippe CUIGNACHE D'APREVAL,REC,947,1.25,1.68,Battu
75,12,56268,186,406,56860,18655,75515,Mme Alienor BILLAULT HARLE,ECO,850,1.13,1.51,Battu
75,12,56268,186,406,56860,18655,75515,M. Arnaud DE GONTAUT BIRON,DVC,449,0.59,0.8,Battu
75,12,56268,186,406,56860,18655,75515,Mme Muriel MONCHAL,EXG,156,0.21,0.28,Battu
75,12,56268,186,406,56860,18655,75515,M. Laszlo FERRÉOL,DVG,19,0.03,0.03,Battu
75,12,56268,186,406,56860,18655,75515,M. Joachim MILESCHI,EXG,0,0,0,Battu
75,13,55845,233,515,56593,21158,77751,M. David AMIEL,ENS,21698,27.91,38.85,Qualif
75,13,55845,233,515,56593,21158,77751,Mme Aminata NIAKATÉ,UG,20722,26.65,37.11,Qualif
75,13,55845,233,515,56593,21158,77751,Mme Sophie ROSTAN,RN,7818,10.06,14,Battu
75,13,55845,233,515,56593,21158,77751,M. Frédéric JACQUOT,DVD,3419,4.4,6.12,Battu
75,13,55845,233,515,56593,21158,77751,M. Victor CHRZANOWSKI,REC,824,1.06,1.48,Battu
75,13,55845,233,515,56593,21158,77751,Mme Ingrid ALLORANT,ECO,811,1.04,1.45,Battu
75,13,55845,233,515,56593,21158,77751,Mme Annie POUPON,REG,234,0.3,0.42,Battu
75,13,55845,233,515,56593,21158,77751,Mme Corinne ROETHLISBERGER,EXG,226,0.29,0.4,Battu
75,13,55845,233,515,56593,21158,77751,Mme Anne-Laure DELINOT,EXD,85,0.11,0.15,Battu
75,13,55845,233,515,56593,21158,77751,Mme Corinne PAINE,DSV,7,0.01,0.01,Battu
75,13,55845,233,515,56593,21158,77751,M. Francis SANDO,DSV,1,0,0,Battu
75,13,55845,233,515,56593,21158,77751,Mme Anne OUDIOU,EXG,0,0,0,Battu
75,14,55235,144,340,55719,20689,76408,M. Benjamin HADDAD,ENS,26351,34.49,47.71,Qualif
75,14,55235,144,340,55719,20689,76408,M. Patrick DRAY,LR,9775,12.79,17.7,Qualif
75,14,55235,144,340,55719,20689,76408,M. Louis PIQUET,UXD,9702,12.7,17.56,Qualif
75,14,55235,144,340,55719,20689,76408,M. Hugo ROTA,UG,7693,10.07,13.93,Battu
75,14,55235,144,340,55719,20689,76408,M. Thomas CULERRIER,REC,1177,1.54,2.13,Battu
75,14,55235,144,340,55719,20689,76408,M. Eric MOLINARI,DVC,414,0.54,0.75,Battu
75,14,55235,144,340,55719,20689,76408,Mme Marie BOURDY,EXG,123,0.16,0.22,Battu
75,14,55235,144,340,55719,20689,76408,M. Sacha Élie ZAOUATI,EXG,0,0,0,Battu
75,15,55178,312,605,56095,23503,79598,Mme Danielle SIMONNET,DVG,23103,29.02,41.87,Qualif
75,15,55178,312,605,56095,23503,79598,Mme Céline VERZELETTI,UG,12619,15.85,22.87,Qualif
75,15,55178,312,605,56095,23503,79598,M. Mohamad GASSAMA,ENS,8948,11.24,16.22,Battu
75,15,55178,312,605,56095,23503,79598,Mme Clotilde GUERY,RN,4969,6.24,9.01,Battu
75,15,55178,312,605,56095,23503,79598,M. François-Marie DIDIER,LR,1968,2.47,3.57,Battu
75,15,55178,312,605,56095,23503,79598,M. Philippe ARAGON,DVC,1634,2.05,2.96,Battu
75,15,55178,312,605,56095,23503,79598,M. Aliou POURCHET,DVC,943,1.18,1.71,Battu
75,15,55178,312,605,56095,23503,79598,M. Christian GUILLOT,REC,558,0.7,1.01,Battu
75,15,55178,312,605,56095,23503,79598,M. Arnaud CHARVILLAT,EXG,275,0.35,0.5,Battu
75,15,55178,312,605,56095,23503,79598,M. Pierre AUGROS,EXG,128,0.16,0.23,Battu
75,15,55178,312,605,56095,23503,79598,M. Laurent CHRÉTIEN MARQUET,DIV,32,0.04,0.06,Battu
75,15,55178,312,605,56095,23503,79598,Mme Audrey LEPAGE,DSV,1,0,0,Battu
75,16,51902,296,516,52714,23703,76417,Mme Sarah LEGRAIN,UG,32422,42.43,62.47,Elu
75,16,51902,296,516,52714,23703,76417,Mme Elsa PARIENTE,ENS,10154,13.29,19.56,Battu
75,16,51902,296,516,52714,23703,76417,Mme Christèle DE FROMONT DE BOUAILLE,RN,4829,6.32,9.3,Battu
75,16,51902,296,516,52714,23703,76417,Mme Marie TOUBIANA,LR,2291,3,4.41,Battu
75,16,51902,296,516,52714,23703,76417,M. Victor HUGUET,ECO,1003,1.31,1.93,Battu
75,16,51902,296,516,52714,23703,76417,Mme Cecile FISCHER,REC,506,0.66,0.97,Battu
75,16,51902,296,516,52714,23703,76417,M. Nordine EL-MARBATI,EXG,409,0.54,0.79,Battu
75,16,51902,296,516,52714,23703,76417,Mme Marie-Noëlle BLONDEL,DVC,287,0.38,0.55,Battu
75,16,51902,296,516,52714,23703,76417,Mme Hakima KHELFA,DIV,1,0,0,Battu
75,16,51902,296,516,52714,23703,76417,Mme Hortense VILLENAVE,EXG,0,0,0,Battu
75,17,40851,281,466,41598,21540,63138,Mme Danièle OBONO,UG,26238,41.56,64.23,Elu
75,17,40851,281,466,41598,21540,63138,Mme Kolia BÉNIÉ,ENS,7012,11.11,17.16,Battu
75,17,40851,281,466,41598,21540,63138,Mme Anne DE LA BRÉLIE,RN,3666,5.81,8.97,Battu
75,17,40851,281,466,41598,21540,63138,Mme Angélique MICHEL,LR,1619,2.56,3.96,Battu
75,17,40851,281,466,41598,21540,63138,M. Mathias SAINT-ELLIER,DVC,744,1.18,1.82,Battu
75,17,40851,281,466,41598,21540,63138,M. Michel BOUCHOU,ECO,578,0.92,1.41,Battu
75,17,40851,281,466,41598,21540,63138,Mme Brigitte RUMEAU,REC,414,0.66,1.01,Battu
75,17,40851,281,466,41598,21540,63138,M. Abdellah AKSAS,EXG,399,0.63,0.98,Battu
75,17,40851,281,466,41598,21540,63138,M. Victor FOURNIER,DVC,181,0.29,0.44,Battu
75,17,40851,281,466,41598,21540,63138,M. Clément ROUSSEAU,EXG,0,0,0,Battu
75,17,40851,281,466,41598,21540,63138,Mme Marie-Agnès VALLEE,DSV,0,0,0,Battu
75,18,52200,223,414,52837,17483,70320,M. Aymeric CARON,UG,26299,37.4,50.38,Elu
75,18,52200,223,414,52837,17483,70320,M. Pierre-Yves BOURNAZEL,ENS,16902,24.04,32.38,Battu
75,18,52200,223,414,52837,17483,70320,Mme Valérie TIREFORT,RN,3641,5.18,6.98,Battu
75,18,52200,223,414,52837,17483,70320,M. Rudolph GRANIER,LR,2184,3.11,4.18,Battu
75,18,52200,223,414,52837,17483,70320,Mme Catherine COUTARD,DVG,811,1.15,1.55,Battu
75,18,52200,223,414,52837,17483,70320,Mme Philippine LONG,DVC,804,1.14,1.54,Battu
75,18,52200,223,414,52837,17483,70320,M. Pierre BRAVOZ,DVG,742,1.06,1.42,Battu
75,18,52200,223,414,52837,17483,70320,Mme Marguerite PIERRE,REC,527,0.75,1.01,Battu
75,18,52200,223,414,52837,17483,70320,Mme Annie BOUBAULT,EXG,214,0.3,0.41,Battu
75,18,52200,223,414,52837,17483,70320,Mme Audrey LE BOEUF,REG,68,0.1,0.13,Battu
75,18,52200,223,414,52837,17483,70320,M. David THIELE,EXG,8,0.01,0.02,Battu
75,18,52200,223,414,52837,17483,70320,Mme Béatrice FAILLÈS,DVC,0,0,0,Battu
75,18,52200,223,414,52837,17483,70320,M. Stéphane MANIGOLD,DVC,0,0,0,Battu
75,18,52200,223,414,52837,17483,70320,Mme Yasmin BERROUBA,DVC,0,0,0,Battu
76,01,45095,208,585,45888,20713,66601,Mme Florence HEROUIN-LÉAUTEY,UG,20040,30.09,44.44,Qualif
76,01,45095,208,585,45888,20713,66601,M. Damien ADAM,ENS,12456,18.7,27.62,Qualif
76,01,45095,208,585,45888,20713,66601,M. Grégoire HOUDAN,RN,8567,12.86,19,Qualif
76,01,45095,208,585,45888,20713,66601,M. Patrick CHABERT,DVD,2606,3.91,5.78,Battu
76,01,45095,208,585,45888,20713,66601,M. Christian SAVEY,REC,465,0.7,1.03,Battu
76,01,45095,208,585,45888,20713,66601,Mme Valérie FOISSEY,EXG,454,0.68,1.01,Battu
76,01,45095,208,585,45888,20713,66601,Mme Marie-Hélène DUVERGER,EXG,271,0.41,0.6,Battu
76,01,45095,208,585,45888,20713,66601,M. Jody HORCHOLLE,DVC,122,0.18,0.27,Battu
76,01,45095,208,585,45888,20713,66601,M. Richard VACQUER,DVG,111,0.17,0.25,Battu
76,01,45095,208,585,45888,20713,66601,M. Mikhail STACHKOV,DIV,3,0,0.01,Battu
76,02,68499,386,1266,70151,25625,95776,Mme Vanessa LANCELOT,RN,23135,24.16,33.77,Qualif
76,02,68499,386,1266,70151,25625,95776,Mme Annie VIDAL,ENS,18996,19.83,27.73,Qualif
76,02,68499,386,1266,70151,25625,95776,M. Vincent DECORDE,UG,16753,17.49,24.46,Qualif
76,02,68499,386,1266,70151,25625,95776,M. Jonas HADDAD,LR,7429,7.76,10.85,Battu
76,02,68499,386,1266,70151,25625,95776,M. Jean-Claude GARAULT,EXG,877,0.92,1.28,Battu
76,02,68499,386,1266,70151,25625,95776,Mme Marie-Françoise ACCARD,DSV,666,0.7,0.97,Battu
76,02,68499,386,1266,70151,25625,95776,M. Frédéric MAZIER,REC,643,0.67,0.94,Battu
76,02,68499,386,1266,70151,25625,95776,M. Soren PETIOT,DVG,0,0,0,Battu
76,03,43173,299,781,44253,26370,70623,M. Edouard BÉNARD,UG,21000,29.74,48.64,Qualif
76,03,43173,299,781,44253,26370,70623,Mme Pauline DANIEL,RN,12194,17.27,28.24,Qualif
76,03,43173,299,781,44253,26370,70623,Mme Letycia OSSIBI,HOR,5951,8.43,13.78,Battu
76,03,43173,299,781,44253,26370,70623,M. Alexis COPPEIN,DVD,2757,3.9,6.39,Battu
76,03,43173,299,781,44253,26370,70623,M. Pascal LE MANACH,EXG,705,1,1.63,Battu
76,03,43173,299,781,44253,26370,70623,M. Anthony VANHESE,REC,566,0.8,1.31,Battu
76,04,53091,420,1146,54657,31630,86287,M. Guillaume PENNELLE,RN,20748,24.05,39.08,Qualif
76,04,53091,420,1146,54657,31630,86287,Mme Alma DUFOUR,UG,17335,20.09,32.65,Qualif
76,04,53091,420,1146,54657,31630,86287,M. Laurent BONNATERRE,HOR,13120,15.21,24.71,Qualif
76,04,53091,420,1146,54657,31630,86287,M. Frédéric PODGUSZER,EXG,1152,1.34,2.17,Battu
76,04,53091,420,1146,54657,31630,86287,Mme Ingrid LOSFELD,REC,736,0.85,1.39,Battu
76,05,63789,367,1156,65312,29562,94874,M. Jean-Cyril MONTIER,RN,26406,27.83,41.4,Qualif
76,05,63789,367,1156,65312,29562,94874,M. Gérard LESEUL,UG,21281,22.43,33.36,Qualif
76,05,63789,367,1156,65312,29562,94874,M. Jean DELALANDRE,HOR,14259,15.03,22.35,Qualif
76,05,63789,367,1156,65312,29562,94874,M. Simon SULKOWSKI,EXG,963,1.02,1.51,Battu
76,05,63789,367,1156,65312,29562,94874,M. Jean-Marc BLED,REC,880,0.93,1.38,Battu
76,06,71784,500,1436,73720,35541,109261,M. Patrice MARTIN,RN,32235,29.5,44.91,Qualif
76,06,71784,500,1436,73720,35541,109261,M. Sébastien JUMEL,UG,24763,22.66,34.5,Qualif
76,06,71784,500,1436,73720,35541,109261,M. Stéphane ACCARD,LR,12916,11.82,17.99,Battu
76,06,71784,500,1436,73720,35541,109261,M. Olivier CLELAND,REC,1009,0.92,1.41,Battu
76,06,71784,500,1436,73720,35541,109261,M. Éric MOISAN,EXG,861,0.79,1.2,Battu
76,07,56651,119,1419,58189,27344,85533,Mme Agnès FIRMIN LE BODO,HOR,19734,23.07,34.83,Qualif
76,07,56651,119,1419,58189,27344,85533,Mme Anaïs THOMAS,RN,16221,18.96,28.63,Qualif
76,07,56651,119,1419,58189,27344,85533,Mme Florence MARTIN PÉRÉON,UG,16211,18.95,28.62,Qualif
76,07,56651,119,1419,58189,27344,85533,M. Jacques FORESTIER,LR,1489,1.74,2.63,Battu
76,07,56651,119,1419,58189,27344,85533,Mme Catherine OMONT,DVG,1292,1.51,2.28,Battu
76,07,56651,119,1419,58189,27344,85533,M. Jean-Paul MACÉ,EXG,610,0.71,1.08,Battu
76,07,56651,119,1419,58189,27344,85533,Mme Isabelle DUCOEURJOLY,REC,553,0.65,0.98,Battu
76,07,56651,119,1419,58189,27344,85533,Mme Véronique DE LA BROSSE,DSV,541,0.63,0.95,Battu
76,08,37849,41,955,38845,25631,64476,M. Jean-Paul LECOQ,UG,16205,25.13,42.81,Qualif
76,08,37849,41,955,38845,25631,64476,Mme Isabelle LE COZ,RN,11855,18.39,31.32,Qualif
76,08,37849,41,955,38845,25631,64476,M. Régis DEBONS,HOR,8040,12.47,21.24,Battu
76,08,37849,41,955,38845,25631,64476,M. Benoit NAOUS,LR,1245,1.93,3.29,Battu
76,08,37849,41,955,38845,25631,64476,Mme Magali CAUCHOIS,EXG,504,0.78,1.33,Battu
76,09,63998,408,1553,65959,29474,95433,M. Douglas POTIER,RN,28528,29.89,44.58,Qualif
76,09,63998,408,1553,65959,29474,95433,Mme Marie-Agnès POUSSIER-WINSBACK,HOR,20528,21.51,32.08,Qualif
76,09,63998,408,1553,65959,29474,95433,Mme Christiane ROUXEL,UG,11845,12.41,18.51,Battu
76,09,63998,408,1553,65959,29474,95433,M. René PINATO,EXG,1122,1.18,1.75,Battu
76,09,63998,408,1553,65959,29474,95433,M. Patrick BUCOURT,DSV,967,1.01,1.51,Battu
76,09,63998,408,1553,65959,29474,95433,M. Christophe ROS,REC,615,0.64,0.96,Battu
76,09,63998,408,1553,65959,29474,95433,Mme Aude DE CASTET,DVC,392,0.41,0.61,Battu
76,09,63998,408,1553,65959,29474,95433,Mme Solène MOREL,DVG,1,0,0,Battu
76,10,76018,607,1694,78319,32566,110885,M. Robert LE BOURGEOIS,RN,34431,31.05,45.29,Qualif
76,10,76018,607,1694,78319,32566,110885,M. Xavier BATUT,HOR,19420,17.51,25.55,Qualif
76,10,76018,607,1694,78319,32566,110885,M. Handy BARRÉ,UG,13254,11.95,17.44,Battu
76,10,76018,607,1694,78319,32566,110885,M. Jean Nicolas ROUSSEAU,DVD,6089,5.49,8.01,Battu
76,10,76018,607,1694,78319,32566,110885,M. Alain RIVIÈRE,EXG,1033,0.93,1.36,Battu
76,10,76018,607,1694,78319,32566,110885,M. Nicolas DUMAS,REC,901,0.81,1.19,Battu
76,10,76018,607,1694,78319,32566,110885,M. Rémy LECUYER,DSV,890,0.8,1.17,Battu
77,01,44130,400,1048,45578,25761,71339,M. Arnaud SAINT-MARTIN,UG,14701,20.61,33.31,Qualif
77,01,44130,400,1048,45578,25761,71339,M. Théo MICHEL,UXD,14542,20.38,32.95,Qualif
77,01,44130,400,1048,45578,25761,71339,Mme Aude LUQUET,ENS,12816,17.96,29.04,Qualif
77,01,44130,400,1048,45578,25761,71339,Mme Brigitte LAPEYRONIE,REC,794,1.11,1.8,Battu
77,01,44130,400,1048,45578,25761,71339,M. Jean-Louis GUERRIER,EXG,742,1.04,1.68,Battu
77,01,44130,400,1048,45578,25761,71339,M. Henri Komivi DJOLEGBEHOU,DVD,298,0.42,0.68,Battu
77,01,44130,400,1048,45578,25761,71339,M. Hicham AICHI,DVG,234,0.33,0.53,Battu
77,01,44130,400,1048,45578,25761,71339,Mme Victoria MEIMOUNI,DSV,3,0,0.01,Battu
77,02,53872,358,926,55156,25288,80444,Mme Ivanka DIMITROVA,RN,18887,23.48,35.06,Qualif
77,02,53872,358,926,55156,25288,80444,M. Frédéric VALLETOUX,ENS,18171,22.59,33.73,Qualif
77,02,53872,358,926,55156,25288,80444,Mme Nour BENAÏSSA WATBOT,UG,12765,15.87,23.7,Qualif
77,02,53872,358,926,55156,25288,80444,M. Loïc ROUSSELLE,ECO,2102,2.61,3.9,Battu
77,02,53872,358,926,55156,25288,80444,M. Guillaume CAZAURAN,REC,991,1.23,1.84,Battu
77,02,53872,358,926,55156,25288,80444,Mme Élodie BROCH,EXG,419,0.52,0.78,Battu
77,02,53872,358,926,55156,25288,80444,Mme Stephanie FAURY,EXG,377,0.47,0.7,Battu
77,02,53872,358,926,55156,25288,80444,M. Valérian LAPKOFF,DIV,152,0.19,0.28,Battu
77,02,53872,358,926,55156,25288,80444,Mme Sophie BALASTRE,DSV,8,0.01,0.01,Battu
77,03,50230,279,983,51492,26422,77914,M. Davy BRUN,RN,19153,24.58,38.13,Qualif
77,03,50230,279,983,51492,26422,77914,M. Jean-Louis THIERIOT,LR,15914,20.43,31.68,Qualif
77,03,50230,279,983,51492,26422,77914,Mme Laura VALLÉE-HANS,UG,14267,18.31,28.4,Qualif
77,03,50230,279,983,51492,26422,77914,Mme Catherine VAN CAUTEREN,EXG,896,1.15,1.78,Battu
77,04,57340,399,1178,58917,29780,88697,M. Julien LIMONGI,RN,27317,30.8,47.64,Qualif
77,04,57340,399,1178,58917,29780,88697,Mme Isabelle PERIGAULT,LR,16060,18.11,28.01,Qualif
77,04,57340,399,1178,58917,29780,88697,M. Mathieu GARNIER,UG,11986,13.51,20.9,Qualif
77,04,57340,399,1178,58917,29780,88697,M. Jean-Yves GAUDEY,EXG,1070,1.21,1.87,Battu
77,04,57340,399,1178,58917,29780,88697,M. Nicolas FAUVEAU,REC,907,1.02,1.58,Battu
77,05,57029,375,1197,58601,31193,89794,M. Philippe FONTANA,UXD,23820,26.53,41.77,Qualif
77,05,57029,375,1197,58601,31193,89794,M. Franck RIESTER,ENS,17923,19.96,31.43,Qualif
77,05,57029,375,1197,58601,31193,89794,Mme Laurie CAENBERGS,UG,13985,15.57,24.52,Qualif
77,05,57029,375,1197,58601,31193,89794,M. Pascal QUENOT,EXG,1011,1.13,1.77,Battu
77,05,57029,375,1197,58601,31193,89794,M. Rudolf LARREGAIN-FELLER,DIV,288,0.32,0.51,Battu
77,05,57029,375,1197,58601,31193,89794,Mme Michèle DURAND,DSV,2,0,0,Battu
77,06,51448,346,1116,52910,29994,82904,Mme Béatrice ROULLAUD,RN,20994,25.32,40.81,Qualif
77,06,51448,346,1116,52910,29994,82904,Mme Amal BENTOUNSI,UG,15548,18.75,30.22,Qualif
77,06,51448,346,1116,52910,29994,82904,M. Régis SARAZIN,DVD,13739,16.57,26.7,Qualif
77,06,51448,346,1116,52910,29994,82904,Mme Annie RIEUPET,EXG,1167,1.41,2.27,Battu
77,07,56489,423,1056,57968,31255,89223,Mme Agnès LAFFITE,RN,20179,22.62,35.72,Qualif
77,07,56489,423,1056,57968,31255,89223,Mme Ersilia SOUDAIS,UG,18557,20.8,32.85,Qualif
77,07,56489,423,1056,57968,31255,89223,M. Christian ROBACHE,ENS,10611,11.89,18.78,Battu
77,07,56489,423,1056,57968,31255,89223,M. Rodrigue KOKOUENDO,DVC,3345,3.75,5.92,Battu
77,07,56489,423,1056,57968,31255,89223,Mme Naïma MOGHIR,DVC,1872,2.1,3.31,Battu
77,07,56489,423,1056,57968,31255,89223,Mme Mathilde YU-YUENG,DSV,678,0.76,1.2,Battu
77,07,56489,423,1056,57968,31255,89223,M. Yannick CARLINO,REC,657,0.74,1.16,Battu
77,07,56489,423,1056,57968,31255,89223,Mme Gabrielle FRIJA,EXG,587,0.66,1.04,Battu
77,07,56489,423,1056,57968,31255,89223,Mme Maria LOURO,UDI,3,0,0.01,Battu
77,08,62442,379,1320,64141,33523,97664,M. Arnaud BONNET,UG,22663,23.21,36.29,Qualif
77,08,62442,379,1320,64141,33523,97664,M. Hadrien GHOMI,ENS,20622,21.12,33.03,Qualif
77,08,62442,379,1320,64141,33523,97664,Mme Manon MOURGERES,RN,17465,17.88,27.97,Qualif
77,08,62442,379,1320,64141,33523,97664,M. Jean-Marc MOSKOWICZ,REC,869,0.89,1.39,Battu
77,08,62442,379,1320,64141,33523,97664,M. Frédéric RENAULT,EXG,822,0.84,1.32,Battu
77,08,62442,379,1320,64141,33523,97664,Mme Henriette SAUVAGE,DSV,1,0,0,Battu
77,08,62442,379,1320,64141,33523,97664,M. Bernard DUCHAUSSOY,ECO,0,0,0,Battu
77,09,55727,283,980,56990,30745,87735,M. Morgann VANACKER,RN,19781,22.55,35.5,Qualif
77,09,55727,283,980,56990,30745,87735,Mme Céline THIÉBAULT-MARTINEZ,UG,16521,18.83,29.65,Qualif
77,09,55727,283,980,56990,30745,87735,Mme Michèle PEYRON,ENS,12023,13.7,21.57,Qualif
77,09,55727,283,980,56990,30745,87735,M. Franck DENION,DVD,3834,4.37,6.88,Battu
77,09,55727,283,980,56990,30745,87735,Mme Marie-Pierre CHEVALLIER,REG,1745,1.99,3.13,Battu
77,09,55727,283,980,56990,30745,87735,M. Kamal VALCIN,REG,775,0.88,1.39,Battu
77,09,55727,283,980,56990,30745,87735,M. Bruno-Charles DELALANDRE,REC,622,0.71,1.12,Battu
77,09,55727,283,980,56990,30745,87735,Mme Florence WOODS,EXG,426,0.49,0.76,Battu
77,10,51341,327,787,52455,30537,82992,M. Maxime LAISNEY,UG,22558,27.18,43.94,Qualif
77,10,51341,327,787,52455,30537,82992,Mme Pryscillia BRACH,RN,11625,14.01,22.64,Qualif
77,10,51341,327,787,52455,30537,82992,Mme Stéphanie DO,ENS,7445,8.97,14.5,Battu
77,10,51341,327,787,52455,30537,82992,M. Michel COLAS,LR,5722,6.89,11.15,Battu
77,10,51341,327,787,52455,30537,82992,M. Joël SANGARÉ,UDI,2707,3.26,5.27,Battu
77,10,51341,327,787,52455,30537,82992,M. Sylvain CAYARD,EXG,688,0.83,1.34,Battu
77,10,51341,327,787,52455,30537,82992,M. Philippe DERVAUX,REC,596,0.72,1.16,Battu
77,11,40513,317,1329,42159,24738,66897,M. Olivier FAURE,UG,21643,32.35,53.42,Elu
77,11,40513,317,1329,42159,24738,66897,M. Vincent PAUL-PETIT,DVD,11902,17.79,29.38,Battu
77,11,40513,317,1329,42159,24738,66897,M. Thomas IANZ,UDI,5797,8.67,14.31,Battu
77,11,40513,317,1329,42159,24738,66897,Mme Anne DE LA TORRE,EXG,868,1.3,2.14,Battu
77,11,40513,317,1329,42159,24738,66897,Mme Flore CREANTOR,REG,171,0.26,0.42,Battu
77,11,40513,317,1329,42159,24738,66897,Mme Dominique MAHÉ,DSV,132,0.2,0.33,Battu
78,01,60315,231,744,61290,22918,84208,M. Charles RODWELL,ENS,20235,24.03,33.55,Qualif
78,01,60315,231,744,61290,22918,84208,M. Sébastien RAMAGE,UG,17073,20.27,28.31,Qualif
78,01,60315,231,744,61290,22918,84208,Mme Anne JACQMIN,RN,11686,13.88,19.37,Qualif
78,01,60315,231,744,61290,22918,84208,M. Arnaud POULAIN,LR,9783,11.62,16.22,Battu
78,01,60315,231,744,61290,22918,84208,Mme Sabine CLEMENT,REC,868,1.03,1.44,Battu
78,01,60315,231,744,61290,22918,84208,M. Jean-Loup LEROUX,EXG,523,0.62,0.87,Battu
78,01,60315,231,744,61290,22918,84208,M. Guillaume CARLIER,DIV,147,0.17,0.24,Battu
78,02,64265,275,701,65241,21738,86979,M. Jean-Noël BARROT,ENS,22500,25.87,35.01,Qualif
78,02,64265,275,701,65241,21738,86979,Mme Maïté CARRIVE-BÉDOUANI,UG,16893,19.42,26.29,Qualif
78,02,64265,275,701,65241,21738,86979,M. Gaetan BRAULT,RN,14013,16.11,21.81,Qualif
78,02,64265,275,701,65241,21738,86979,M. Pascal THEVENOT,LR,9327,10.72,14.51,Battu
78,02,64265,275,701,65241,21738,86979,M. Philippe LOIRE,REC,893,1.03,1.39,Battu
78,02,64265,275,701,65241,21738,86979,Mme Marielle SAULNIER,EXG,486,0.56,0.76,Battu
78,02,64265,275,701,65241,21738,86979,M. Bertrand HUGON,DIV,153,0.18,0.24,Battu
78,03,60221,242,592,61055,22466,83521,Mme Béatrice PIRON,ENS,20768,24.87,34.49,Qualif
78,03,60221,242,592,61055,22466,83521,M. Valentin SALVINO,UXD,13725,16.43,22.79,Qualif
78,03,60221,242,592,61055,22466,83521,M. Thomas CIANO,UG,12557,15.03,20.85,Qualif
78,03,60221,242,592,61055,22466,83521,M. Othman NASROU,LR,10211,12.23,16.96,Battu
78,03,60221,242,592,61055,22466,83521,M. Jérémy BIZET,ECO,1679,2.01,2.79,Battu
78,03,60221,242,592,61055,22466,83521,M. Olivier LE COQ,REC,998,1.19,1.66,Battu
78,03,60221,242,592,61055,22466,83521,M. Olivier AUGUSTIN,EXG,283,0.34,0.47,Battu
78,04,58027,269,833,59129,21729,80858,Mme Marie LEBEC,ENS,23932,29.6,41.24,Qualif
78,04,58027,269,833,59129,21729,80858,Mme Céline BOURDON,UG,15787,19.52,27.21,Qualif
78,04,58027,269,833,59129,21729,80858,M. Jean-François MOURTOUX,UXD,11599,14.34,19.99,Qualif
78,04,58027,269,833,59129,21729,80858,Mme Anne-Sophie HO MASSAT,LR,5383,6.66,9.28,Battu
78,04,58027,269,833,59129,21729,80858,Mme Manon BARDY,REC,835,1.03,1.44,Battu
78,04,58027,269,833,59129,21729,80858,M. Franck MAUREL,EXG,489,0.6,0.84,Battu
78,04,58027,269,833,59129,21729,80858,M. James POGGIA,DIV,2,0,0,Battu
78,05,53451,235,949,54635,22131,76766,Mme Yaël BRAUN-PIVET,ENS,22874,29.8,42.79,Qualif
78,05,53451,235,949,54635,22131,76766,M. Yassine BENYETTOU,UG,14600,19.02,27.31,Qualif
78,05,53451,235,949,54635,22131,76766,M. Jacques MYARD,DVD,12241,15.95,22.9,Qualif
78,05,53451,235,949,54635,22131,76766,Mme Emilienne GUILLE,REC,1826,2.38,3.42,Battu
78,05,53451,235,949,54635,22131,76766,Mme Nathalie LEPAGE,DVC,942,1.23,1.76,Battu
78,05,53451,235,949,54635,22131,76766,M. Alain LÉPICIER,EXG,454,0.59,0.85,Battu
78,05,53451,235,949,54635,22131,76766,Mme Ingrid LAROSE,DVC,430,0.56,0.8,Battu
78,05,53451,235,949,54635,22131,76766,M. Serilo LOOKY,DVG,84,0.11,0.16,Battu
78,06,52726,233,623,53582,23514,77096,Mme Natalia POUZYREFF,ENS,20212,26.22,38.33,Qualif
78,06,52726,233,623,53582,23514,77096,Mme Mélinda SAUGER,UG,14247,18.48,27.02,Qualif
78,06,52726,233,623,53582,23514,77096,Mme Sophie LELANDAIS,RN,10781,13.98,20.45,Qualif
78,06,52726,233,623,53582,23514,77096,M. Stéphane TORREZ,LR,4028,5.22,7.64,Battu
78,06,52726,233,623,53582,23514,77096,M. Jean-Luc SUZÉ,ECO,1668,2.16,3.16,Battu
78,06,52726,233,623,53582,23514,77096,Mme Anne-Elisabeth SILD,REC,760,0.99,1.44,Battu
78,06,52726,233,623,53582,23514,77096,Mme Claire COUEIGNAS,DSV,533,0.69,1.01,Battu
78,06,52726,233,623,53582,23514,77096,Mme Cécile PERRAUDIN,EXG,222,0.29,0.42,Battu
78,06,52726,233,623,53582,23514,77096,M. Ken ARMÈDE,EXG,120,0.16,0.23,Battu
78,06,52726,233,623,53582,23514,77096,M. Patrice HERNOT,DVD,84,0.11,0.16,Battu
78,06,52726,233,623,53582,23514,77096,M. Marc PHILIPOT,DIV,71,0.09,0.13,Battu
78,06,52726,233,623,53582,23514,77096,M. Leo MÜLLBACHER,DIV,0,0,0,Battu
78,07,54231,283,893,55407,26206,81613,M. Aurélien ROUSSEAU,UG,18810,23.05,34.68,Qualif
78,07,54231,283,893,55407,26206,81613,Mme Nadia HAI,ENS,15903,19.49,29.32,Qualif
78,07,54231,283,893,55407,26206,81613,Mme Babette DE ROZIERES,UXD,13987,17.14,25.79,Qualif
78,07,54231,283,893,55407,26206,81613,M. Julien FRÉJABUE,LR,4142,5.08,7.64,Battu
78,07,54231,283,893,55407,26206,81613,Mme Colette AUBREE,REC,516,0.63,0.95,Battu
78,07,54231,283,893,55407,26206,81613,M. Ali KAYA,EXG,498,0.61,0.92,Battu
78,07,54231,283,893,55407,26206,81613,M. Jack LEFEBVRE,EXG,375,0.46,0.69,Battu
78,08,45452,389,810,46651,28696,75347,M. Benjamin LUCAS,UG,20416,27.1,44.92,Qualif
78,08,45452,389,810,46651,28696,75347,M. Cyril NAUTH,RN,14076,18.68,30.97,Qualif
78,08,45452,389,810,46651,28696,75347,M. Alexis COSTA,ENS,6436,8.54,14.16,Battu
78,08,45452,389,810,46651,28696,75347,M. Stephan CHAMPAGNE,UDI,2592,3.44,5.7,Battu
78,08,45452,389,810,46651,28696,75347,Mme Sabah EL ASRI,DIV,1208,1.6,2.66,Battu
78,08,45452,389,810,46651,28696,75347,M. Thierry GONNOT,EXG,526,0.7,1.16,Battu
78,08,45452,389,810,46651,28696,75347,M. Nicolas MANGANI,DIV,187,0.25,0.41,Battu
78,08,45452,389,810,46651,28696,75347,M. Hugues BOVAERE,REC,8,0.01,0.02,Battu
78,08,45452,389,810,46651,28696,75347,M. Léon CHEVALIER,DIV,3,0,0.01,Battu
78,09,62493,381,1037,63911,30212,94123,M. Laurent MORIN,RN,21551,22.9,34.49,Qualif
78,09,62493,381,1037,63911,30212,94123,Mme Dieynaba DIOP,UG,18520,19.68,29.64,Qualif
78,09,62493,381,1037,63911,30212,94123,M. Bruno MILLIENNE,ENS,13340,14.17,21.35,Qualif
78,09,62493,381,1037,63911,30212,94123,M. Hervé RIOU,DVD,5563,5.91,8.9,Battu
78,09,62493,381,1037,63911,30212,94123,M. Rachid ZEROUALI,ECO,1780,1.89,2.85,Battu
78,09,62493,381,1037,63911,30212,94123,M. Christophe LE HOT,REC,802,0.85,1.28,Battu
78,09,62493,381,1037,63911,30212,94123,M. Philippe GOMMARD,EXG,601,0.64,0.96,Battu
78,09,62493,381,1037,63911,30212,94123,M. Sendil-Sébastien DJEARAMANE,DIV,336,0.36,0.54,Battu
78,10,66593,326,872,67791,24689,92480,Mme Aurore BERGÉ,ENS,22367,24.19,33.59,Qualif
78,10,66593,326,872,67791,24689,92480,M. Thomas DU CHALARD,RN,18795,20.32,28.22,Qualif
78,10,66593,326,872,67791,24689,92480,M. Cédric BRIOLAIS,UG,14918,16.13,22.4,Qualif
78,10,66593,326,872,67791,24689,92480,M. Gaël BARBOTIN,LR,5797,6.27,8.71,Battu
78,10,66593,326,872,67791,24689,92480,M. Julien GAUTRELET,RDG,2260,2.44,3.39,Battu
78,10,66593,326,872,67791,24689,92480,Mme Ethel FOURNIER-CAMPION,ECO,1141,1.23,1.71,Battu
78,10,66593,326,872,67791,24689,92480,M. Olivier GOUSSEAU,REC,894,0.97,1.34,Battu
78,10,66593,326,872,67791,24689,92480,Mme Hélène JANISSET,EXG,421,0.46,0.63,Battu
78,11,47011,300,816,48127,22503,70630,M. William MARTINET,UG,20395,28.88,43.38,Qualif
78,11,47011,300,816,48127,22503,70630,M. Laurent MAZAURY,UDI,13752,19.47,29.25,Qualif
78,11,47011,300,816,48127,22503,70630,Mme Victoria DOUCET,RN,10243,14.5,21.79,Qualif
78,11,47011,300,816,48127,22503,70630,Mme Sarah NICOS,DIV,1048,1.48,2.23,Battu
78,11,47011,300,816,48127,22503,70630,Mme Nathalie MACHUCA,REC,900,1.27,1.91,Battu
78,11,47011,300,816,48127,22503,70630,M. Patrick PLANQUE,EXG,507,0.72,1.08,Battu
78,11,47011,300,816,48127,22503,70630,M. Boris LUTZ,DSV,166,0.24,0.35,Battu
78,12,50577,268,820,51665,20675,72340,M. Karl OLIVE,ENS,20610,28.49,40.75,Qualif
78,12,50577,268,820,51665,20675,72340,M. Christophe MASSIAUX,UG,15333,21.2,30.32,Qualif
78,12,50577,268,820,51665,20675,72340,M. Jean-Louis METTELET,RN,12585,17.4,24.88,Qualif
78,12,50577,268,820,51665,20675,72340,M. Bruno JAY,REC,743,1.03,1.47,Battu
78,12,50577,268,820,51665,20675,72340,M. Jean-Pierre MERCIER,EXG,537,0.74,1.06,Battu
78,12,50577,268,820,51665,20675,72340,M. Patrick SCIELLER,DIV,400,0.55,0.79,Battu
78,12,50577,268,820,51665,20675,72340,M. Diabé KAMARA,DVG,369,0.51,0.73,Battu
79,01,62736,692,1298,64726,27022,91748,M. Bastien MARCHIVE,DVC,25247,27.52,40.24,Qualif
79,01,62736,692,1298,64726,27022,91748,Mme Nathalie LANZI,UG,20571,22.42,32.79,Qualif
79,01,62736,692,1298,64726,27022,91748,Mme Dorothée CHAMPEAU,RN,15447,16.84,24.62,Qualif
79,01,62736,692,1298,64726,27022,91748,Mme Virginie JULIARD,REC,773,0.84,1.23,Battu
79,01,62736,692,1298,64726,27022,91748,Mme Danielle VAUZELLE,EXG,698,0.76,1.11,Battu
79,01,62736,692,1298,64726,27022,91748,M. Marc René GAILLARD,DVG,0,0,0,Battu
79,02,65945,846,1471,68262,29792,98054,Mme Delphine BATHO,ECO,25435,25.94,38.57,Qualif
79,02,65945,846,1471,68262,29792,98054,Mme Mélody GARAULT,RN,22500,22.95,34.12,Qualif
79,02,65945,846,1471,68262,29792,98054,M. Frédéric BIZARD,ENS,10536,10.75,15.98,Battu
79,02,65945,846,1471,68262,29792,98054,Mme Emilie BAUDREZ,LR,6107,6.23,9.26,Battu
79,02,65945,846,1471,68262,29792,98054,M. Guy BOURDON,REC,760,0.78,1.15,Battu
79,02,65945,846,1471,68262,29792,98054,M. Roger GORIZZUTTI,EXG,607,0.62,0.92,Battu
79,03,55765,837,1336,57938,27376,85314,M. Philippe ROBIN,UXD,19671,23.06,35.27,Qualif
79,03,55765,837,1336,57938,27376,85314,M. Jean-Marie FIÉVET,ENS,17352,20.34,31.12,Qualif
79,03,55765,837,1336,57938,27376,85314,Mme Juliette WOILLEZ,UG,10564,12.38,18.94,Battu
79,03,55765,837,1336,57938,27376,85314,M. Mattieu MANCEAU,LR,7512,8.81,13.47,Battu
79,03,55765,837,1336,57938,27376,85314,Mme Maryse VALLÉE,EXG,666,0.78,1.19,Battu
79,03,55765,837,1336,57938,27376,85314,M. Jacky DURAND,DVG,0,0,0,Battu
80,01,52625,459,926,54010,29094,83104,Mme Nathalie RIBEIRO BILLET,RN,21413,25.77,40.69,Qualif
80,01,52625,459,926,54010,29094,83104,M. François RUFFIN,UG,17850,21.48,33.92,Qualif
80,01,52625,459,926,54010,29094,83104,Mme Albane BRANLANT,ENS,11933,14.36,22.68,Qualif
80,01,52625,459,926,54010,29094,83104,M. Bruno DUMONT,DVC,776,0.93,1.47,Battu
80,01,52625,459,926,54010,29094,83104,M. Jean-Patrick BAUDRY,EXG,653,0.79,1.24,Battu
80,02,51505,301,756,52562,24779,77341,Mme Zahia HAMDANE,UG,15217,19.68,29.54,Qualif
80,02,51505,301,756,52562,24779,77341,M. Damien TOUMI,RN,14142,18.29,27.46,Qualif
80,02,51505,301,756,52562,24779,77341,M. Hubert DE JENLIS,ENS,12997,16.8,25.23,Qualif
80,02,51505,301,756,52562,24779,77341,Mme Anne PINON,LR,3450,4.46,6.7,Battu
80,02,51505,301,756,52562,24779,77341,M. Renaud DESCHAMPS,DVC,2029,2.62,3.94,Battu
80,02,51505,301,756,52562,24779,77341,Mme Ingrid DORDAIN,DVC,1589,2.05,3.09,Battu
80,02,51505,301,756,52562,24779,77341,M. Paul-Eric DECLE,DVC,1096,1.42,2.13,Battu
80,02,51505,301,756,52562,24779,77341,M. Rémy CHASSOULIER,EXG,531,0.69,1.03,Battu
80,02,51505,301,756,52562,24779,77341,Mme Suzanne PLAQUET,REC,410,0.53,0.8,Battu
80,02,51505,301,756,52562,24779,77341,M. Grégoire LECOCQ,DSV,44,0.06,0.09,Battu
80,03,55777,549,1128,57454,24569,82023,M. Matthias RENAULT,RN,27277,33.26,48.9,Qualif
80,03,55777,549,1128,57454,24569,82023,M. Emmanuel MAQUET,LR,15449,18.83,27.7,Qualif
80,03,55777,549,1128,57454,24569,82023,M. Léon DEFFONTAINES,UG,8385,10.22,15.03,Battu
80,03,55777,549,1128,57454,24569,82023,M. Bruno MARIAGE,ENS,3490,4.25,6.26,Battu
80,03,55777,549,1128,57454,24569,82023,M. Michel VALET,EXG,589,0.72,1.06,Battu
80,03,55777,549,1128,57454,24569,82023,Mme Sylvie BRUHAT,REC,370,0.45,0.66,Battu
80,03,55777,549,1128,57454,24569,82023,M. Noë BOXOËN,DSV,217,0.26,0.39,Battu
80,04,57558,446,1178,59182,25898,85080,M. Jean-Philippe TANGUY,RN,28559,33.57,49.62,Qualif
80,04,57558,446,1178,59182,25898,85080,M. Anthony GEST,ENS,10631,12.5,18.47,Qualif
80,04,57558,446,1178,59182,25898,85080,Mme Elodie HÉREN,UG,9789,11.51,17.01,Battu
80,04,57558,446,1178,59182,25898,85080,M. Vincent JACQUES,LR,7759,9.12,13.48,Battu
80,04,57558,446,1178,59182,25898,85080,M. Guy VITOUX,EXG,820,0.96,1.42,Battu
80,05,52306,495,1137,53938,27253,81191,Mme Yaël MENACHE,RN,29281,36.06,55.98,Elu
80,05,52306,495,1137,53938,27253,81191,M. Loïc FOLLEAT,ENS,10196,12.56,19.49,Battu
80,05,52306,495,1137,53938,27253,81191,Mme Alice BERGER,UG,6877,8.47,13.15,Battu
80,05,52306,495,1137,53938,27253,81191,Mme Séverine MORDACQ,LR,4280,5.27,8.18,Battu
80,05,52306,495,1137,53938,27253,81191,Mme Hélène LAUNAY,EXG,1000,1.23,1.91,Battu
80,05,52306,495,1137,53938,27253,81191,Mme Béatrice GUILBERT,REC,672,0.83,1.28,Battu
81,01,58776,683,1314,60773,24571,85344,M. Frédéric CABROLIER,RN,23237,27.23,39.53,Qualif
81,01,58776,683,1314,60773,24571,85344,M. Philippe BONNECARRERE,DVC,17352,20.33,29.52,Qualif
81,01,58776,683,1314,60773,24571,85344,Mme Margot LAPEYRE,UG,16673,19.54,28.37,Qualif
81,01,58776,683,1314,60773,24571,85344,M. Denis ROUQUETTE,REC,769,0.9,1.31,Battu
81,01,58776,683,1314,60773,24571,85344,M. Eric CHAVEGRAND,EXG,567,0.66,0.96,Battu
81,01,58776,683,1314,60773,24571,85344,M. Orphée PAUTHIER,DVG,178,0.21,0.3,Battu
81,02,76040,1015,2034,79089,31221,110310,M. Julien BACOU,RN,28850,26.15,37.94,Qualif
81,02,76040,1015,2034,79089,31221,110310,Mme Karen ERODI,UG,24048,21.8,31.63,Qualif
81,02,76040,1015,2034,79089,31221,110310,M. Pierre VERDIER,ENS,16501,14.96,21.7,Qualif
81,02,76040,1015,2034,79089,31221,110310,M. Thierno BAH,LR,4082,3.7,5.37,Battu
81,02,76040,1015,2034,79089,31221,110310,M. Joël ENCONTRE,REG,1058,0.96,1.39,Battu
81,02,76040,1015,2034,79089,31221,110310,M. Frederic LAMOUCHE,REC,989,0.9,1.3,Battu
81,02,76040,1015,2034,79089,31221,110310,M. Boris GIMENEZ SASTRE,EXG,512,0.46,0.67,Battu
81,03,72970,959,1794,75723,29057,104780,M. Guilhem CARAYON,UXD,31748,30.3,43.51,Qualif
81,03,72970,959,1794,75723,29057,104780,M. Jean TERLIER,ENS,20870,19.92,28.6,Qualif
81,03,72970,959,1794,75723,29057,104780,M. Julien LASSALLE,UG,18525,17.68,25.39,Qualif
81,03,72970,959,1794,75723,29057,104780,Mme Claire DAUGÉ,REG,965,0.92,1.32,Battu
81,03,72970,959,1794,75723,29057,104780,Mme Chantal TRESSENS,EXG,767,0.73,1.05,Battu
81,03,72970,959,1794,75723,29057,104780,M. Alban AZAIS,DSV,95,0.09,0.13,Battu
82,01,63220,907,1991,66118,27306,93424,Mme Brigitte BAREGES,UXD,27772,29.73,43.93,Qualif
82,01,63220,907,1991,66118,27306,93424,Mme Valérie RABAULT,UG,23271,24.91,36.81,Qualif
82,01,63220,907,1991,66118,27306,93424,Mme Catherine SIMONIN-BENAZET,ENS,9791,10.48,15.49,Battu
82,01,63220,907,1991,66118,27306,93424,M. Richard BLANCO,EXG,1178,1.26,1.86,Battu
82,01,63220,907,1991,66118,27306,93424,M. Jean-François GRILHAULT DES FONTAINES,DIV,769,0.82,1.22,Battu
82,01,63220,907,1991,66118,27306,93424,M. Alain BRU,DVC,439,0.47,0.69,Battu
82,02,66252,818,1538,68608,28586,97194,Mme Marine HAMELET,RN,32578,33.52,49.17,Qualif
82,02,66252,818,1538,68608,28586,97194,Mme Claudie CHRETIEN,UG,12286,12.64,18.54,Qualif
82,02,66252,818,1538,68608,28586,97194,M. Jules DUFFAUT,ENS,10335,10.63,15.6,Battu
82,02,66252,818,1538,68608,28586,97194,Mme Anne IUS,RDG,9952,10.24,15.02,Battu
82,02,66252,818,1538,68608,28586,97194,Mme Françoise RATSIMBA,EXG,791,0.81,1.19,Battu
82,02,66252,818,1538,68608,28586,97194,Mme Claire AYMES,REG,310,0.32,0.47,Battu
83,01,45492,286,869,46647,24452,71099,M. Sébastien SOULÉ,RN,19233,27.05,42.28,Qualif
83,01,45492,286,869,46647,24452,71099,M. Yannick CHENEVARD,ENS,14270,20.07,31.37,Qualif
83,01,45492,286,869,46647,24452,71099,M. Eric HABOUZIT,UG,10182,14.32,22.38,Qualif
83,01,45492,286,869,46647,24452,71099,M. Guillaume TCHAKMAKDJIAN,REC,1197,1.68,2.63,Battu
83,01,45492,286,869,46647,24452,71099,M. Marie-Renée BALTY,EXG,610,0.86,1.34,Battu
83,02,60129,436,1042,61607,31212,92819,Mme Laure LAVALETTE,RN,30551,32.91,50.81,Elu
83,02,60129,436,1042,61607,31212,92819,Mme Josy CHAMBON,ENS,13061,14.07,21.72,Battu
83,02,60129,436,1042,61607,31212,92819,Mme Isaline CORNIL,UG,11613,12.51,19.31,Battu
83,02,60129,436,1042,61607,31212,92819,M. Olivier LESAGE,ECO,2500,2.69,4.16,Battu
83,02,60129,436,1042,61607,31212,92819,Mme Julia BONNEFOY,REC,1506,1.62,2.5,Battu
83,02,60129,436,1042,61607,31212,92819,M. Jean-Michel GHIOTTO,EXG,493,0.53,0.82,Battu
83,02,60129,436,1042,61607,31212,92819,M. Florian FIMBEL,DIV,405,0.44,0.67,Battu
83,03,69544,479,981,71004,32268,103272,M. Stéphane RAMBAUD,RN,32343,31.32,46.51,Qualif
83,03,69544,479,981,71004,32268,103272,Mme Isabelle MONFORT,ENS,14057,13.61,20.21,Qualif
83,03,69544,479,981,71004,32268,103272,Mme Julia PEIRONET BREMOND,UG,12839,12.43,18.46,Battu
83,03,69544,479,981,71004,32268,103272,M. Julien SAVELLI,LR,6117,5.92,8.8,Battu
83,03,69544,479,981,71004,32268,103272,M. Charles MALOT,ECO,1574,1.52,2.26,Battu
83,03,69544,479,981,71004,32268,103272,Mme Odile JUDICE,REC,1369,1.33,1.97,Battu
83,03,69544,479,981,71004,32268,103272,Mme Delphine ROLLAND,REG,531,0.51,0.76,Battu
83,03,69544,479,981,71004,32268,103272,M. Alexis DOMINIAK,ECO,455,0.44,0.65,Battu
83,03,69544,479,981,71004,32268,103272,M. Pierre DEIDON,EXG,259,0.25,0.37,Battu
83,04,72415,747,1219,74381,39563,113944,M. Philippe LOTTIAUX,RN,40631,35.66,56.11,Elu
83,04,72415,747,1219,74381,39563,113944,Mme Sereine MAUBORGNE,ENS,18994,16.67,26.23,Battu
83,04,72415,747,1219,74381,39563,113944,Mme Sabine CRISTOFANI-VIGLIONE,UG,9416,8.26,13,Battu
83,04,72415,747,1219,74381,39563,113944,M. Guillaume ROBAA,ECO,2697,2.37,3.72,Battu
83,04,72415,747,1219,74381,39563,113944,Mme Pascale MOREL,EXG,677,0.59,0.93,Battu
83,05,66969,529,812,68310,34041,102351,Mme Julie LECHANTEUX,RN,34496,33.7,51.51,Elu
83,05,66969,529,812,68310,34041,102351,M. Philippe MICHEL-KLEISBAUER,ENS,14890,14.55,22.23,Battu
83,05,66969,529,812,68310,34041,102351,M. Aurelien LACOUR,UG,8450,8.26,12.62,Battu
83,05,66969,529,812,68310,34041,102351,Mme Danièle LOMBARD,LR,5304,5.18,7.92,Battu
83,05,66969,529,812,68310,34041,102351,Mme Hélène Charlotte DE BUSSCHÈRE,ECO,2058,2.01,3.07,Battu
83,05,66969,529,812,68310,34041,102351,M. Vincent THIERY,REC,1429,1.4,2.13,Battu
83,05,66969,529,812,68310,34041,102351,M. Rémi KRANZER,EXG,342,0.33,0.51,Battu
83,06,85745,610,1614,87969,40889,128858,M. Frank GILETTI,RN,45882,35.61,53.51,Elu
83,06,85745,610,1614,87969,40889,128858,M. Fabrice ALBERT,UDI,15451,11.99,18.02,Battu
83,06,85745,610,1614,87969,40889,128858,Mme Sylvie VINCENEUX,UG,14683,11.39,17.12,Battu
83,06,85745,610,1614,87969,40889,128858,M. Frédéric HERBAUT,LR,5527,4.29,6.45,Battu
83,06,85745,610,1614,87969,40889,128858,M. Didier CADE,REG,1968,1.53,2.3,Battu
83,06,85745,610,1614,87969,40889,128858,Mme Sandra CAHOREAU,REC,1508,1.17,1.76,Battu
83,06,85745,610,1614,87969,40889,128858,M. Louis GUEYRARD,EXG,726,0.56,0.85,Battu
83,07,67807,364,921,69092,34674,103766,M. Frédéric BOCCALETTI,RN,32748,31.56,48.3,Qualif
83,07,67807,364,921,69092,34674,103766,Mme Cécile MUSCHOTTI,ENS,12567,12.11,18.53,Qualif
83,07,67807,364,921,69092,34674,103766,Mme Claudie CARTEREAU,UG,12166,11.72,17.94,Battu
83,07,67807,364,921,69092,34674,103766,Mme Sandra KUNTZ,LR,5129,4.94,7.56,Battu
83,07,67807,364,921,69092,34674,103766,M. Sébastien GIOIA,DVC,1870,1.8,2.76,Battu
83,07,67807,364,921,69092,34674,103766,Mme Laurile KOSCIELSKI,ECO,1169,1.13,1.72,Battu
83,07,67807,364,921,69092,34674,103766,M. Mathieu REHO,REC,887,0.85,1.31,Battu
83,07,67807,364,921,69092,34674,103766,Mme Marie-Eve PERRU,ECO,819,0.79,1.21,Battu
83,07,67807,364,921,69092,34674,103766,M. Patrice CIUTI,EXG,381,0.37,0.56,Battu
83,07,67807,364,921,69092,34674,103766,Mme Christèle GUENIOT-DESMAZURES,DSV,71,0.07,0.1,Battu
83,08,71775,667,1509,73951,36188,110139,M. Philippe SCHRECK,RN,38433,34.89,53.55,Elu
83,08,71775,667,1509,73951,36188,110139,Mme Sarah BREFFY,UG,14420,13.09,20.09,Battu
83,08,71775,667,1509,73951,36188,110139,M. Rayann MOUSLIM,ENS,11368,10.32,15.84,Battu
83,08,71775,667,1509,73951,36188,110139,M. Frank PANIZZI,LR,6639,6.03,9.25,Battu
83,08,71775,667,1509,73951,36188,110139,M. Ludovic MARTIN,EXG,915,0.83,1.27,Battu
83,08,71775,667,1509,73951,36188,110139,M. Francis COMBE,DIV,0,0,0,Battu
84,01,45047,329,771,46147,27872,74019,Mme Catherine JAOUEN,RN,15595,21.07,34.62,Qualif
84,01,45047,329,771,46147,27872,74019,M. Raphaël ARNAULT,UG,11155,15.07,24.76,Qualif
84,01,45047,329,771,46147,27872,74019,M. Philippe PASCAL,DVG,8229,11.12,18.27,Battu
84,01,45047,329,771,46147,27872,74019,Mme Malika DI FRAJA,ENS,7264,9.81,16.13,Battu
84,01,45047,329,771,46147,27872,74019,M. Johan COURTOIS,LR,1459,1.97,3.24,Battu
84,01,45047,329,771,46147,27872,74019,M. Philippe TOUTAIN,REC,594,0.8,1.32,Battu
84,01,45047,329,771,46147,27872,74019,Mme Christine CHATENAY,REG,391,0.53,0.87,Battu
84,01,45047,329,771,46147,27872,74019,M. Eddine GHOUALI,EXG,360,0.49,0.8,Battu
84,02,58027,482,1081,59590,26889,86479,Mme Bénédicte AUZANOT,RN,26665,30.83,45.95,Qualif
84,02,58027,482,1081,59590,26889,86479,M. Patrick BLANES,UG,14421,16.68,24.85,Qualif
84,02,58027,482,1081,59590,26889,86479,Mme Sylvie VIALA,ENS,11260,13.02,19.4,Qualif
84,02,58027,482,1081,59590,26889,86479,Mme Dominique BROGI,LR,4008,4.63,6.91,Battu
84,02,58027,482,1081,59590,26889,86479,M. Julien LANGARD,REC,999,1.16,1.72,Battu
84,02,58027,482,1081,59590,26889,86479,M. Gérard MANGIAVILLANO,EXG,590,0.68,1.02,Battu
84,02,58027,482,1081,59590,26889,86479,M. José-Angel SANCHEZ,DIV,84,0.1,0.14,Battu
84,03,52612,520,1112,54244,25064,79308,M. Hervé DE LÉPINAU,RN,28153,35.5,53.51,Elu
84,03,52612,520,1112,54244,25064,79308,Mme Muriel DUENAS,UG,10895,13.74,20.71,Battu
84,03,52612,520,1112,54244,25064,79308,Mme Souad ZITOUNI,ENS,8947,11.28,17.01,Battu
84,03,52612,520,1112,54244,25064,79308,M. Christophe TONNAIRE,LR,3284,4.14,6.24,Battu
84,03,52612,520,1112,54244,25064,79308,M. Bertrand HELLEU,EXG,671,0.85,1.28,Battu
84,03,52612,520,1112,54244,25064,79308,M. Louis ROUSSEL,REC,662,0.83,1.26,Battu
84,04,60516,510,1411,62437,28203,90640,Mme Marie-France LORHO,RN,30192,33.31,49.89,Qualif
84,04,60516,510,1411,62437,28203,90640,Mme Monia GALVEZ,UG,11887,13.11,19.64,Qualif
84,04,60516,510,1411,62437,28203,90640,Mme Lise Anne Sophie CHAUVOT,ENS,10449,11.53,17.27,Battu
84,04,60516,510,1411,62437,28203,90640,M. David MARSEILLE,LR,2685,2.96,4.44,Battu
84,04,60516,510,1411,62437,28203,90640,Mme Marie-Claude BOMPARD,REC,2125,2.34,3.51,Battu
84,04,60516,510,1411,62437,28203,90640,M. Bruno COULON,UDI,1893,2.09,3.13,Battu
84,04,60516,510,1411,62437,28203,90640,Mme Anne Marie HAUTANT,REG,729,0.8,1.2,Battu
84,04,60516,510,1411,62437,28203,90640,M. Nicolas PETILLOT,EXG,556,0.61,0.92,Battu
84,05,56444,683,1163,58290,26656,84946,Mme Catherine RIMBERT,RN,25415,29.92,45.03,Qualif
84,05,56444,683,1163,58290,26656,84946,Mme Céline CELCE,UG,15329,18.05,27.16,Qualif
84,05,56444,683,1163,58290,26656,84946,M. Adrien MORENAS,ENS,11454,13.48,20.29,Qualif
84,05,56444,683,1163,58290,26656,84946,M. Martin LEFEVRE,LR,3512,4.13,6.22,Battu
84,05,56444,683,1163,58290,26656,84946,M. Alexandre DESHAIES,REC,734,0.86,1.3,Battu
85,01,81151,947,1879,83977,36734,120711,M. Simon-Pierre PAULIN,UXD,26105,21.63,32.17,Qualif
85,01,81151,947,1879,83977,36734,120711,M. Philippe LATOMBE,ENS,23136,19.17,28.51,Qualif
85,01,81151,947,1879,83977,36734,120711,Mme Lucie ETONNO,UG,18929,15.68,23.33,Qualif
85,01,81151,947,1879,83977,36734,120711,M. Laurent CAILLAUD,DVC,10606,8.79,13.07,Battu
85,01,81151,947,1879,83977,36734,120711,M. Jean-Marc BARIAL,DSV,1433,1.19,1.77,Battu
85,01,81151,947,1879,83977,36734,120711,M. Gilles ROBIN,EXG,942,0.78,1.16,Battu
85,02,78115,792,1703,80610,33474,114084,Mme Béatrice BELLAMY,ENS,30262,26.53,38.74,Qualif
85,02,78115,792,1703,80610,33474,114084,Mme Marie-Christine EBRAN,RN,28538,25.01,36.53,Qualif
85,02,78115,792,1703,80610,33474,114084,M. Nicolas HELARY,UG,18234,15.98,23.34,Qualif
85,02,78115,792,1703,80610,33474,114084,Mme Sophie BARILLOT,EXG,1081,0.95,1.38,Battu
85,03,94261,955,1882,97098,39795,136893,M. Pascal DUBIN,UXD,33545,24.5,35.59,Qualif
85,03,94261,955,1882,97098,39795,136893,M. Stéphane BUCHOU,ENS,32889,24.03,34.89,Qualif
85,03,94261,955,1882,97098,39795,136893,Mme Pascale MARCHAND,UG,15466,11.3,16.41,Battu
85,03,94261,955,1882,97098,39795,136893,M. Noël FAUCHER,DVD,8221,6.01,8.72,Battu
85,03,94261,955,1882,97098,39795,136893,M. Eric MAUVOISIN-DELAVAUD,EXD,1895,1.38,2.01,Battu
85,03,94261,955,1882,97098,39795,136893,Mme Armelle Marie Geneviève GUÉNOLÉ,DSV,1428,1.04,1.51,Battu
85,03,94261,955,1882,97098,39795,136893,M. Philippe FESTIEN,EXG,817,0.6,0.87,Battu
85,04,71453,533,1442,73428,31289,104717,Mme Véronique BESSE,DVD,28086,26.82,39.31,Qualif
85,04,71453,533,1442,73428,31289,104717,M. Jacques PROUX,RN,16345,15.61,22.88,Qualif
85,04,71453,533,1442,73428,31289,104717,M. Ilias NAGNONHOU,ENS,13192,12.6,18.46,Qualif
85,04,71453,533,1442,73428,31289,104717,Mme Julie MARIEL-GODARD,UG,13164,12.57,18.42,Qualif
85,04,71453,533,1442,73428,31289,104717,Mme Claude BOUR,EXG,666,0.64,0.93,Battu
85,05,56270,651,1061,57982,26026,84008,M. Stéphane BUFFETAUT,RN,21309,25.37,37.87,Qualif
85,05,56270,651,1061,57982,26026,84008,M. Pierre HENRIET,ENS,19606,23.34,34.84,Qualif
85,05,56270,651,1061,57982,26026,84008,M. Pierre-Hugues FOURAGE,UG,11321,13.48,20.12,Qualif
85,05,56270,651,1061,57982,26026,84008,M. Marius GALAND,LR,2633,3.13,4.68,Battu
85,05,56270,651,1061,57982,26026,84008,Mme Sonia LE THEIX,DSV,742,0.88,1.32,Battu
85,05,56270,651,1061,57982,26026,84008,Mme Béatrice RUAULT,EXG,659,0.78,1.17,Battu
86,01,55023,577,1045,56645,24408,81053,Mme Lisa BELLUCO,UG,18232,22.49,33.14,Qualif
86,01,55023,577,1045,56645,24408,81053,Mme Emmanuelle DARLES,RN,15918,19.64,28.93,Qualif
86,01,55023,577,1045,56645,24408,81053,Mme Séverine SAINT-PÉ,HOR,15875,19.59,28.85,Qualif
86,01,55023,577,1045,56645,24408,81053,M. Aurélien TRICOT,DVG,4399,5.43,7.99,Battu
86,01,55023,577,1045,56645,24408,81053,M. Ludovic GAILLARD,EXG,599,0.74,1.09,Battu
86,02,56767,516,896,58179,22028,80207,M. Sacha HOULIÉ,ENS,18855,23.51,33.21,Qualif
86,02,56767,516,896,58179,22028,80207,Mme Valérie SOUMAILLE,UG,16254,20.27,28.63,Qualif
86,02,56767,516,896,58179,22028,80207,Mme Estelle CHEVALLIER,RN,13864,17.29,24.42,Qualif
86,02,56767,516,896,58179,22028,80207,M. Aurélien BOURDIER,DVG,5723,7.14,10.08,Battu
86,02,56767,516,896,58179,22028,80207,M. Xavier AUGAY,DVD,1658,2.07,2.92,Battu
86,02,56767,516,896,58179,22028,80207,Mme Agnès CHAUVIN,EXG,413,0.51,0.73,Battu
86,03,48716,767,1182,50665,21754,72419,M. Eric SOULAT,RN,19887,27.46,40.82,Qualif
86,03,48716,767,1182,50665,21754,72419,M. Pascal LECAMP,ENS,14704,20.3,30.18,Qualif
86,03,48716,767,1182,50665,21754,72419,Mme Gisèle JEAN,UG,13020,17.98,26.73,Qualif
86,03,48716,767,1182,50665,21754,72419,Mme Soizic JOUAN,EXG,688,0.95,1.41,Battu
86,03,48716,767,1182,50665,21754,72419,Mme Tatiana GOUVERNEUR,ECO,417,0.58,0.86,Battu
86,04,46951,640,945,48536,25143,73679,Mme Hager JACQUEMIN,RN,19268,26.15,41.04,Qualif
86,04,46951,640,945,48536,25143,73679,M. Nicolas TURQUOIS,ENS,15076,20.46,32.11,Qualif
86,04,46951,640,945,48536,25143,73679,M. Yves TROUSSELLE,UG,9901,13.44,21.09,Qualif
86,04,46951,640,945,48536,25143,73679,M. Patrick MINOT,DVC,1263,1.71,2.69,Battu
86,04,46951,640,945,48536,25143,73679,Mme Sabine BORTOLOTTI,DSV,752,1.02,1.6,Battu
86,04,46951,640,945,48536,25143,73679,M. Patrice VILLERET,EXG,691,0.94,1.47,Battu
87,01,57588,959,1403,59950,23998,83948,M. Damien MAUDET,UG,21271,25.34,36.94,Qualif
87,01,57588,959,1403,59950,23998,83948,Mme Camille DOS SANTOS DE OLIVEIRA,RN,18904,22.52,32.83,Qualif
87,01,57588,959,1403,59950,23998,83948,Mme Isabelle NEGRIER,ENS,15544,18.52,26.99,Qualif
87,01,57588,959,1403,59950,23998,83948,M. Serge MORETTI,DSV,1066,1.27,1.85,Battu
87,01,57588,959,1403,59950,23998,83948,Mme Elisabeth FAUCON,EXG,803,0.96,1.39,Battu
87,02,69286,1502,1875,72663,25675,98338,Mme Sabrina MINGUET,RN,25539,25.97,36.86,Qualif
87,02,69286,1502,1875,72663,25675,98338,M. Stéphane DELAUTRETTE,UG,25520,25.95,36.83,Qualif
87,02,69286,1502,1875,72663,25675,98338,Mme Marie-Eve TAYOT,ENS,16937,17.22,24.45,Qualif
87,02,69286,1502,1875,72663,25675,98338,Mme Claudine ROUSSIE,EXG,1290,1.31,1.86,Battu
87,03,55413,1122,1551,58086,23307,81393,Mme Manon MEUNIER,UG,19494,23.95,35.18,Qualif
87,03,55413,1122,1551,58086,23307,81393,M. Albin FREYCHET,RN,19310,23.72,34.85,Qualif
87,03,55413,1122,1551,58086,23307,81393,M. Gilles TOULZA,DVC,14768,18.14,26.65,Qualif
87,03,55413,1122,1551,58086,23307,81393,Mme Zohra RADJETTI,DSV,1044,1.28,1.88,Battu
87,03,55413,1122,1551,58086,23307,81393,M. Daniel MOURNETAS,EXG,797,0.98,1.44,Battu
88,01,49478,508,761,50747,25237,75984,M. Stéphane VIRY,DVD,21200,27.9,42.85,Qualif
88,01,49478,508,761,50747,25237,75984,M. Pierre FRANÇOIS,RN,18886,24.86,38.17,Qualif
88,01,49478,508,761,50747,25237,75984,Mme Dominique PERRIN,UG,8655,11.39,17.49,Battu
88,01,49478,508,761,50747,25237,75984,Mme Evelyne ABBOT,EXG,737,0.97,1.49,Battu
88,02,47315,458,850,48623,23273,71896,M. Gaëtan DUSSAUSAYE,RN,22788,31.7,48.16,Qualif
88,02,47315,458,850,48623,23273,71896,M. David VALENCE,ENS,14592,20.3,30.84,Qualif
88,02,47315,458,850,48623,23273,71896,Mme Julie XICOLA,UG,7312,10.17,15.45,Battu
88,02,47315,458,850,48623,23273,71896,Mme Emma GATEAU,LR,1202,1.67,2.54,Battu
88,02,47315,458,850,48623,23273,71896,M. Emmanuel THIEBAUT,DVC,925,1.29,1.95,Battu
88,02,47315,458,850,48623,23273,71896,Mme Jeanne-Françoise LANGLADE,EXG,486,0.68,1.03,Battu
88,02,47315,458,850,48623,23273,71896,M. Lionel CHAMBROT,ECO,10,0.01,0.02,Battu
88,03,42733,267,543,43543,19807,63350,M. Christophe NAEGELEN,DVD,20652,32.6,48.33,Qualif
88,03,42733,267,543,43543,19807,63350,Mme Pauline FRESSE,RN,14287,22.55,33.43,Qualif
88,03,42733,267,543,43543,19807,63350,M. Etienne BACHELART,UG,7283,11.5,17.04,Battu
88,03,42733,267,543,43543,19807,63350,Mme Stéphanie BAILLY,EXG,511,0.81,1.2,Battu
88,04,42755,471,1019,44245,19876,64121,M. Sébastien HUMBERT,RN,20529,32.02,48.02,Qualif
88,04,42755,471,1019,44245,19876,64121,M. Jean-Jacques GAULTIER,LR,13644,21.28,31.91,Qualif
88,04,42755,471,1019,44245,19876,64121,M. François-Xavier WEIN,UG,6851,10.68,16.02,Battu
88,04,42755,471,1019,44245,19876,64121,Mme Camille BAILLY,EXG,674,1.05,1.58,Battu
88,04,42755,471,1019,44245,19876,64121,Mme Caroline HUBERT,REC,538,0.84,1.26,Battu
88,04,42755,471,1019,44245,19876,64121,Mme Marie BENI,DVC,519,0.81,1.21,Battu
89,01,50707,357,933,51997,22976,74973,M. Daniel GRENON,RN,20486,27.32,40.4,Qualif
89,01,50707,357,933,51997,22976,74973,Mme Florence LOURY,UG,12851,17.14,25.34,Qualif
89,01,50707,357,933,51997,22976,74973,M. Victor ALBRECHT,ENS,8871,11.83,17.49,Battu
89,01,50707,357,933,51997,22976,74973,Mme Céline BÄHR,LR,7303,9.74,14.4,Battu
89,01,50707,357,933,51997,22976,74973,Mme Sylvie MANIGAUT,EXG,654,0.87,1.29,Battu
89,01,50707,357,933,51997,22976,74973,M. Jean-Christophe LETIERCE,REC,542,0.72,1.07,Battu
89,02,47173,649,1015,48837,23423,72260,Mme Sophie-Laurence ROY,UXD,20997,29.06,44.51,Qualif
89,02,47173,649,1015,48837,23423,72260,M. André VILLIERS,ENS,13837,19.15,29.33,Qualif
89,02,47173,649,1015,48837,23423,72260,M. Philippe VEYSSIERE,UG,9197,12.73,19.5,Qualif
89,02,47173,649,1015,48837,23423,72260,Mme Iris NAKOV,ECO,1019,1.41,2.16,Battu
89,02,47173,649,1015,48837,23423,72260,M. Thomas VERHEGGE,DSV,895,1.24,1.9,Battu
89,02,47173,649,1015,48837,23423,72260,Mme Sylvie DEMUSSY,REC,620,0.86,1.31,Battu
89,02,47173,649,1015,48837,23423,72260,Mme Anita CARRASCO,EXG,608,0.84,1.29,Battu
89,03,56968,483,1053,58504,31212,89716,M. Julien ODOUL,RN,28735,32.03,50.44,Elu
89,03,56968,483,1053,58504,31212,89716,M. Nicolas SORET,UG,14530,16.2,25.51,Battu
89,03,56968,483,1053,58504,31212,89716,Mme Michèle CROUZET,ENS,9973,11.12,17.51,Battu
89,03,56968,483,1053,58504,31212,89716,M. Grégoire WEIGEL,DVD,2271,2.53,3.99,Battu
89,03,56968,483,1053,58504,31212,89716,Mme Annik VILBOIS,REC,568,0.63,1,Battu
89,03,56968,483,1053,58504,31212,89716,Mme Simonne PALLANT,EXG,541,0.6,0.95,Battu
89,03,56968,483,1053,58504,31212,89716,M. Jean-Charles KERMIN,EXG,350,0.39,0.61,Battu
90,01,32014,276,479,32769,14784,47553,Mme Carine MANCK,RN,12718,26.74,39.73,Qualif
90,01,32014,276,479,32769,14784,47553,M. Ian BOUCARD,LR,7679,16.15,23.99,Qualif
90,01,32014,276,479,32769,14784,47553,Mme Marie-Eve BELORGEY,UG,7233,15.21,22.59,Qualif
90,01,32014,276,479,32769,14784,47553,Mme Maggy GROSDIDIER,ENS,3608,7.59,11.27,Battu
90,01,32014,276,479,32769,14784,47553,Mme Christiane PETITOT,EXG,426,0.9,1.33,Battu
90,01,32014,276,479,32769,14784,47553,Mme Marion KEMPS HOUVER,DSV,350,0.74,1.09,Battu
90,01,32014,276,479,32769,14784,47553,Mme Séverine MERLINI,REG,0,0,0,Battu
90,02,31400,328,533,32261,14246,46507,M. Guillaume BIGOT,RN,11888,25.56,37.86,Qualif
90,02,31400,328,533,32261,14246,46507,M. Florian CHAUCHE,UG,8799,18.92,28.02,Qualif
90,02,31400,328,533,32261,14246,46507,M. Didier VALLVERDU,LR,5422,11.66,17.27,Battu
90,02,31400,328,533,32261,14246,46507,Mme Josée MARTINEZ,ENS,4794,10.31,15.27,Battu
90,02,31400,328,533,32261,14246,46507,M. Simon PHEULPIN,EXG,497,1.07,1.58,Battu
90,02,31400,328,533,32261,14246,46507,Mme Célia KECK,REG,0,0,0,Battu
91,01,41475,350,703,42528,27266,69794,Mme Farida AMRANI,UG,19109,27.38,46.07,Qualif
91,01,41475,350,703,42528,27266,69794,M. Stéphane BEAUDET,DIV,11506,16.49,27.74,Qualif
91,01,41475,350,703,42528,27266,69794,M. Thiebauld VEGA,RN,9264,13.27,22.34,Qualif
91,01,41475,350,703,42528,27266,69794,M. Jean CAMONIN,EXG,565,0.81,1.36,Battu
91,01,41475,350,703,42528,27266,69794,Mme Hélène BERENGER,REC,539,0.77,1.3,Battu
91,01,41475,350,703,42528,27266,69794,M. Baptiste GALAND,ECO,405,0.58,0.98,Battu
91,01,41475,350,703,42528,27266,69794,Mme Gladys EYANG,DIV,87,0.12,0.21,Battu
91,02,61064,493,1276,62833,30085,92918,Mme Nathalie DA CONCEICAO CARVALHO,RN,24608,26.48,40.3,Qualif
91,02,61064,493,1276,62833,30085,92918,M. Mathieu HILLAIRE,UG,16207,17.44,26.54,Qualif
91,02,61064,493,1276,62833,30085,92918,Mme Naïma SIFER,ENS,13490,14.52,22.09,Qualif
91,02,61064,493,1276,62833,30085,92918,M. Pierre MAYEUR,DVD,2054,2.21,3.36,Battu
91,02,61064,493,1276,62833,30085,92918,M. Alexandre LIENHARD,ECO,1754,1.89,2.87,Battu
91,02,61064,493,1276,62833,30085,92918,M. Jacques BORIE,ECO,1389,1.49,2.27,Battu
91,02,61064,493,1276,62833,30085,92918,Mme Carla TARCY,REC,1045,1.12,1.71,Battu
91,02,61064,493,1276,62833,30085,92918,Mme Mathilde PHAN HIEU,EXG,517,0.56,0.85,Battu
91,03,67526,451,1293,69270,29864,99134,M. Stefan MILOSEVIC,RN,22290,22.48,33.01,Qualif
91,03,67526,451,1293,69270,29864,99134,M. Steevy GUSTAVE,UG,20874,21.06,30.91,Qualif
91,03,67526,451,1293,69270,29864,99134,M. Alexis IZARD,ENS,20189,20.37,29.9,Qualif
91,03,67526,451,1293,69270,29864,99134,Mme Catherine BOMPARD,DIV,2453,2.47,3.63,Battu
91,03,67526,451,1293,69270,29864,99134,M. Denis TRANIER,REC,925,0.93,1.37,Battu
91,03,67526,451,1293,69270,29864,99134,Mme Joëlle LOPÈS-VENOT,EXG,713,0.72,1.06,Battu
91,03,67526,451,1293,69270,29864,99134,M. Salvador RIBEIRO,DIV,82,0.08,0.12,Battu
91,04,68148,493,1656,70297,29316,99613,Mme Marie-Pierre RIXAIN,ENS,23108,23.2,33.91,Qualif
91,04,68148,493,1656,70297,29316,99613,M. Jérôme CARBRIAND,UXD,21144,21.23,31.03,Qualif
91,04,68148,493,1656,70297,29316,99613,M. Amadou DEME,UG,21010,21.09,30.83,Qualif
91,04,68148,493,1656,70297,29316,99613,M. Tony GOMES,REC,1177,1.18,1.73,Battu
91,04,68148,493,1656,70297,29316,99613,Mme Michèle POHYER,EXG,790,0.79,1.16,Battu
91,04,68148,493,1656,70297,29316,99613,M. Jean-François RICOIS,DIV,500,0.5,0.73,Battu
91,04,68148,493,1656,70297,29316,99613,M. Yves MARTY,DIV,419,0.42,0.61,Battu
91,05,50381,227,501,51109,17597,68706,M. Pierre LARROUTUROU,UG,19107,27.81,37.93,Qualif
91,05,50381,227,501,51109,17597,68706,M. Paul MIDY,ENS,16362,23.81,32.48,Qualif
91,05,50381,227,501,51109,17597,68706,Mme Laetitia HORVELIN,RN,7692,11.2,15.27,Battu
91,05,50381,227,501,51109,17597,68706,M. François Guy TRÉBULLE,DVD,4998,7.27,9.92,Battu
91,05,50381,227,501,51109,17597,68706,Mme Marianne BILLOIR,ECO,898,1.31,1.78,Battu
91,05,50381,227,501,51109,17597,68706,Mme Wendy LONCHAMPT,REC,627,0.91,1.24,Battu
91,05,50381,227,501,51109,17597,68706,M. Benoît ODILLE,DVG,380,0.55,0.75,Battu
91,05,50381,227,501,51109,17597,68706,M. Didier PAXION,EXG,317,0.46,0.63,Battu
91,06,55983,231,817,57031,26293,83324,M. Jérôme GUEDJ,UG,19280,23.14,34.44,Qualif
91,06,55983,231,817,57031,26293,83324,Mme Hella KRIBI - ROMDHANE,DVG,14124,16.95,25.23,Qualif
91,06,55983,231,817,57031,26293,83324,Mme Natacha GOUPY,RN,11650,13.98,20.81,Qualif
91,06,55983,231,817,57031,26293,83324,Mme Chantal LACARRIERE FARGES,LR,8119,9.74,14.5,Battu
91,06,55983,231,817,57031,26293,83324,M. Aloïs LANG-ROUSSEAU,ECO,1455,1.75,2.6,Battu
91,06,55983,231,817,57031,26293,83324,Mme Francine MONNIER,REC,1075,1.29,1.92,Battu
91,06,55983,231,817,57031,26293,83324,M. Bastien VAYSSIÈRE,EXG,280,0.34,0.5,Battu
91,07,46565,307,760,47632,26516,74148,Mme Claire LEJEUNE,UG,19012,25.64,40.83,Qualif
91,07,46565,307,760,47632,26516,74148,M. Robin REDA,ENS,14000,18.88,30.07,Qualif
91,07,46565,307,760,47632,26516,74148,Mme Audrey GUIBERT,RN,11676,15.75,25.07,Qualif
91,07,46565,307,760,47632,26516,74148,M. Olivier VAGNEUX,DVD,694,0.94,1.49,Battu
91,07,46565,307,760,47632,26516,74148,M. Olivier VILLETTE,DIV,606,0.82,1.3,Battu
91,07,46565,307,760,47632,26516,74148,M. Didier CORMIER,REC,577,0.78,1.24,Battu
91,08,49422,318,818,50558,26007,76565,M. Bérenger CERNON,UG,16986,22.19,34.37,Qualif
91,08,49422,318,818,50558,26007,76565,M. Nicolas DUPONT-AIGNAN,DSV,16288,21.27,32.96,Qualif
91,08,49422,318,818,50558,26007,76565,M. François DUROVRAY,DVD,13532,17.67,27.38,Qualif
91,08,49422,318,818,50558,26007,76565,Mme Amina BOUATLAOUI,ECO,1683,2.2,3.41,Battu
91,08,49422,318,818,50558,26007,76565,Mme Chantal DUBOULAY,EXG,432,0.56,0.87,Battu
91,08,49422,318,818,50558,26007,76565,Mme Lolita DUQUENOY,DIV,283,0.37,0.57,Battu
91,08,49422,318,818,50558,26007,76565,M. Jean-Baptiste TAOFIFENUA,DVC,218,0.28,0.44,Battu
91,09,51296,319,1057,52672,27115,79787,Mme Julie OZENNE,UG,19288,24.17,37.6,Qualif
91,09,51296,319,1057,52672,27115,79787,M. Paul-Henri MERRIEN,RN,15449,19.36,30.12,Qualif
91,09,51296,319,1057,52672,27115,79787,Mme Marie GUÉVENOUX,ENS,13908,17.43,27.11,Qualif
91,09,51296,319,1057,52672,27115,79787,M. Bruno CHAMBERLIN,DIV,1652,2.07,3.22,Battu
91,09,51296,319,1057,52672,27115,79787,M. Benoit GRISAUD,EXG,831,1.04,1.62,Battu
91,09,51296,319,1057,52672,27115,79787,M. Sinan BORAN,DIV,168,0.21,0.33,Battu
91,10,37763,344,596,38703,24121,62824,M. Antoine LÉAUMENT,UG,16242,25.85,43.01,Qualif
91,10,37763,344,596,38703,24121,62824,M. Michael AMAND,RN,9784,15.57,25.91,Qualif
91,10,37763,344,596,38703,24121,62824,Mme Alexandra MONET,ENS,7137,11.36,18.9,Battu
91,10,37763,344,596,38703,24121,62824,M. Nicolas DE BOISHUE,LR,2207,3.51,5.84,Battu
91,10,37763,344,596,38703,24121,62824,M. Thierry DENEUVE,ECO,694,1.1,1.84,Battu
91,10,37763,344,596,38703,24121,62824,M. Kamel KECER,ECO,622,0.99,1.65,Battu
91,10,37763,344,596,38703,24121,62824,Mme Stéphanie HAMON,REC,373,0.59,0.99,Battu
91,10,37763,344,596,38703,24121,62824,Mme Monique LECLERC,EXG,317,0.5,0.84,Battu
91,10,37763,344,596,38703,24121,62824,M. Willy DECKEL,DIV,257,0.41,0.68,Battu
91,10,37763,344,596,38703,24121,62824,M. Joël MANDO,DVD,70,0.11,0.19,Battu
91,10,37763,344,596,38703,24121,62824,M. Mihala KABAMA,DIV,60,0.1,0.16,Battu
92,01,40455,177,831,41463,26255,67718,Mme Elsa FAUCILLON,UG,26225,38.73,64.83,Elu
92,01,40455,177,831,41463,26255,67718,Mme Mariam CAMARA,RN,5464,8.07,13.51,Battu
92,01,40455,177,831,41463,26255,67718,M. Frédéric SARKIS,ENS,5369,7.93,13.27,Battu
92,01,40455,177,831,41463,26255,67718,Mme Diane DE LONGUEVILLE,LR,1752,2.59,4.33,Battu
92,01,40455,177,831,41463,26255,67718,M. Nicolas FEGEANT,UDI,596,0.88,1.47,Battu
92,01,40455,177,831,41463,26255,67718,Mme Zina BOUNAB,EXG,368,0.54,0.91,Battu
92,01,40455,177,831,41463,26255,67718,Mme Marie-Laure DECAILLET,REC,346,0.51,0.86,Battu
92,01,40455,177,831,41463,26255,67718,Mme Armelle PERTUS,EXG,218,0.32,0.54,Battu
92,01,40455,177,831,41463,26255,67718,Mme Marine MASSONNEAU,DVC,117,0.17,0.29,Battu
92,02,52326,186,777,53289,18402,71691,M. Thomas LAM,LR,21760,30.35,41.59,Qualif
92,02,52326,186,777,53289,18402,71691,Mme Francesca PASQUINI,UG,20683,28.85,39.53,Qualif
92,02,52326,186,777,53289,18402,71691,Mme Anne-Caroline GALLIMARD,UXD,6817,9.51,13.03,Battu
92,02,52326,186,777,53289,18402,71691,M. Sébastien PHAN,DVC,1188,1.66,2.27,Battu
92,02,52326,186,777,53289,18402,71691,Mme Julia PETTITT,REC,637,0.89,1.22,Battu
92,02,52326,186,777,53289,18402,71691,M. Ahmed LAKRAFI,DVC,564,0.79,1.08,Battu
92,02,52326,186,777,53289,18402,71691,M. Julien PUERTAS,EXG,360,0.5,0.69,Battu
92,02,52326,186,777,53289,18402,71691,M. Louis DUROULLE,DVC,317,0.44,0.61,Battu
92,03,59717,107,897,60721,22374,83095,M. Philippe JUVIN,LR,31109,37.44,52.09,Elu
92,03,59717,107,897,60721,22374,83095,Mme Isabelle DAHAN,UG,18774,22.59,31.44,Battu
92,03,59717,107,897,60721,22374,83095,Mme Carole ROUSSEL,RN,8478,10.2,14.2,Battu
92,03,59717,107,897,60721,22374,83095,M. Marc GERARD,REC,992,1.19,1.66,Battu
92,03,59717,107,897,60721,22374,83095,Mme Aline FRADIN,EXG,364,0.44,0.61,Battu
92,04,53677,204,1002,54883,26195,81078,Mme Sabrina SEBAIHI,UG,26373,32.53,49.13,Qualif
92,04,53677,204,1002,54883,26195,81078,Mme Isabelle DE CRECY,ENS,15899,19.61,29.62,Qualif
92,04,53677,204,1002,54883,26195,81078,Mme Melina BRAVO,RN,8185,10.1,15.25,Battu
92,04,53677,204,1002,54883,26195,81078,Mme Aurélie VONSY,ECO,1086,1.34,2.02,Battu
92,04,53677,204,1002,54883,26195,81078,M. Régis VALETTE,REC,758,0.93,1.41,Battu
92,04,53677,204,1002,54883,26195,81078,M. Laurent STRUMANNE,EXG,425,0.52,0.79,Battu
92,04,53677,204,1002,54883,26195,81078,Mme Mathilde EISENBERG,EXG,391,0.48,0.73,Battu
92,04,53677,204,1002,54883,26195,81078,M. Valéry BARNY,DVG,297,0.37,0.55,Battu
92,04,53677,204,1002,54883,26195,81078,M. Sean Phillip MC COY,DVG,263,0.32,0.49,Battu
92,05,54572,232,423,55227,22261,77488,M. Raphaël PITTI,UG,19939,25.73,36.54,Qualif
92,05,54572,232,423,55227,22261,77488,Mme Céline CALVEZ,ENS,17255,22.27,31.62,Qualif
92,05,54572,232,423,55227,22261,77488,Mme Amélie PINÇON,UXD,7869,10.16,14.42,Battu
92,05,54572,232,423,55227,22261,77488,Mme Sophie DESCHIENS,LR,6935,8.95,12.71,Battu
92,05,54572,232,423,55227,22261,77488,Mme Hayat BAKHTI,UDI,891,1.15,1.63,Battu
92,05,54572,232,423,55227,22261,77488,Mme Josette BOTET,REC,571,0.74,1.05,Battu
92,05,54572,232,423,55227,22261,77488,M. Benjamin DEWHURST,DIV,542,0.7,0.99,Battu
92,05,54572,232,423,55227,22261,77488,Mme Mireille LAMBERT,EXG,343,0.44,0.63,Battu
92,05,54572,232,423,55227,22261,77488,Mme Alexandra RIU,DVC,227,0.29,0.42,Battu
92,06,56366,156,702,57224,19223,76447,Mme Constance LE GRIP,ENS,22627,29.6,40.14,Qualif
92,06,56366,156,702,57224,19223,76447,M. Geoffroy DIDIER,LR,11217,14.67,19.9,Qualif
92,06,56366,156,702,57224,19223,76447,Mme Sihame MUSCIANISI,UG,10857,14.2,19.26,Qualif
92,06,56366,156,702,57224,19223,76447,M. Alexis PANY,UXD,9512,12.44,16.88,Battu
92,06,56366,156,702,57224,19223,76447,M. Jean MESSIHA,REC,1776,2.32,3.15,Battu
92,06,56366,156,702,57224,19223,76447,Mme Françoise MARCEL,EXG,352,0.46,0.62,Battu
92,06,56366,156,702,57224,19223,76447,M. François-Xavier DEROCHE,DVC,25,0.03,0.04,Battu
92,07,64006,304,1198,65508,22831,88339,M. Pierre CAZENEUVE,ENS,34053,38.55,53.2,Elu
92,07,64006,304,1198,65508,22831,88339,M. Lucas PEYRET,UG,14749,16.7,23.04,Battu
92,07,64006,304,1198,65508,22831,88339,Mme Christine PASTOR,RN,12057,13.65,18.84,Battu
92,07,64006,304,1198,65508,22831,88339,Mme Charlotte RICHARD,ECO,1633,1.85,2.55,Battu
92,07,64006,304,1198,65508,22831,88339,M. Rémi CARILLON,REC,1083,1.23,1.69,Battu
92,07,64006,304,1198,65508,22831,88339,Mme Cécile ABAD,EXG,431,0.49,0.67,Battu
92,08,50793,117,687,51597,16608,68205,Mme Prisca THEVENOT,ENS,20274,29.73,39.91,Qualif
92,08,50793,117,687,51597,16608,68205,Mme Salomé NICOLAS-CHAVANCE,UG,15392,22.57,30.3,Qualif
92,08,50793,117,687,51597,16608,68205,Mme Delphine VEISSIERE,RN,7979,11.7,15.71,Battu
92,08,50793,117,687,51597,16608,68205,Mme Cécile RICHEZ,LR,4959,7.27,9.76,Battu
92,08,50793,117,687,51597,16608,68205,M. Miron CUSA,DVG,968,1.42,1.91,Battu
92,08,50793,117,687,51597,16608,68205,Mme Adélaïde MOTTE,REC,626,0.92,1.23,Battu
92,08,50793,117,687,51597,16608,68205,M. Adam BRAHIMI-SEMPER,ECO,350,0.51,0.69,Battu
92,08,50793,117,687,51597,16608,68205,M. Philippe HÉNIQUE,EXG,196,0.29,0.39,Battu
92,08,50793,117,687,51597,16608,68205,M. Jean-Baptiste LAYLY,DIV,49,0.07,0.1,Battu
92,09,46869,0,796,47665,15798,63463,M. Stéphane SÉJOURNÉ,ENS,21593,34.02,46.07,Qualif
92,09,46869,0,796,47665,15798,63463,Mme Pauline RAPILLY-FERNIOT,UG,10024,15.8,21.39,Qualif
92,09,46869,0,796,47665,15798,63463,Mme Virginie MATHOT,LR,7108,11.2,15.17,Battu
92,09,46869,0,796,47665,15798,63463,Mme Julia CARRASCO,RN,6528,10.29,13.93,Battu
92,09,46869,0,796,47665,15798,63463,M. Joseph SAMOUN,REC,840,1.32,1.79,Battu
92,09,46869,0,796,47665,15798,63463,Mme Hazrije MUSTAFIC,DVC,459,0.72,0.98,Battu
92,09,46869,0,796,47665,15798,63463,Mme Anne-Laure CHAUDON,EXG,225,0.35,0.48,Battu
92,09,46869,0,796,47665,15798,63463,M. Thierry NARBONI,DVD,92,0.14,0.2,Battu
92,10,58553,76,1034,59663,20580,80243,M. Gabriel ATTAL,ENS,25675,32,43.85,Qualif
92,10,58553,76,1034,59663,20580,80243,Mme Cécile SOUBELET,UG,20806,25.93,35.53,Qualif
92,10,58553,76,1034,59663,20580,80243,M. Sébastien LAYE,UXD,7732,9.64,13.21,Battu
92,10,58553,76,1034,59663,20580,80243,M. Clément PERRIN,LR,2972,3.7,5.08,Battu
92,10,58553,76,1034,59663,20580,80243,M. Herlander FERREIRA DO AMARAL,REC,766,0.95,1.31,Battu
92,10,58553,76,1034,59663,20580,80243,Mme Laurence VIGUIÉ,EXG,315,0.39,0.54,Battu
92,10,58553,76,1034,59663,20580,80243,Mme Béatrice GUILLEMET,DVG,150,0.19,0.26,Battu
92,10,58553,76,1034,59663,20580,80243,M. Nicolas LEMESLE,DIV,109,0.14,0.19,Battu
92,10,58553,76,1034,59663,20580,80243,M. Esteban YGOUF,DVG,28,0.03,0.05,Battu
92,11,49923,312,647,50882,20777,71659,M. Aurélien SAINTOUL,UG,25031,34.93,50.14,Elu
92,11,49923,312,647,50882,20777,71659,Mme Laurianne ROSSI,ENS,15036,20.98,30.12,Battu
92,11,49923,312,647,50882,20777,71659,Mme Juliette CHATELAIN,RN,6737,9.4,13.49,Battu
92,11,49923,312,647,50882,20777,71659,M. Eric ROUX,DVC,1039,1.45,2.08,Battu
92,11,49923,312,647,50882,20777,71659,M. Renaud COUZIN,ECO,797,1.11,1.6,Battu
92,11,49923,312,647,50882,20777,71659,Mme Suzanne BACLET,REC,491,0.69,0.98,Battu
92,11,49923,312,647,50882,20777,71659,M. Franck ROLLOT,EXG,281,0.39,0.56,Battu
92,11,49923,312,647,50882,20777,71659,M. Olivier GARDENT,DVG,196,0.27,0.39,Battu
92,11,49923,312,647,50882,20777,71659,M. Xavier CHIARELLI,EXG,161,0.22,0.32,Battu
92,11,49923,312,647,50882,20777,71659,M. Philippe PONGE,DVG,154,0.21,0.31,Battu
92,12,67943,359,827,69129,24694,93823,M. Jean-Didier BERGER,LR,26790,28.55,39.43,Qualif
92,12,67943,359,827,69129,24694,93823,M. Lounes ADJROUD,UG,26034,27.75,38.32,Qualif
92,12,67943,359,827,69129,24694,93823,M. Christophe VERSINI,RN,11710,12.48,17.24,Battu
92,12,67943,359,827,69129,24694,93823,M. Stéphane LEGRAND,ECO,1762,1.88,2.59,Battu
92,12,67943,359,827,69129,24694,93823,M. Philippe HOUPLAIN,REC,736,0.78,1.08,Battu
92,12,67943,359,827,69129,24694,93823,M. Guillaume CHINAN,DVG,444,0.47,0.65,Battu
92,12,67943,359,827,69129,24694,93823,M. Yann BERNARD,EXG,444,0.47,0.65,Battu
92,12,67943,359,827,69129,24694,93823,Mme Assma BENHARKAT,DVG,23,0.02,0.03,Battu
92,13,65652,87,1251,66990,22348,89338,Mme Maud BREGEON,ENS,25721,28.79,39.18,Qualif
92,13,65652,87,1251,66990,22348,89338,M. Brice GAILLARD,UG,24798,27.76,37.77,Qualif
92,13,65652,87,1251,66990,22348,89338,M. Patrick YVARS,RN,9629,10.78,14.67,Battu
92,13,65652,87,1251,66990,22348,89338,M. Numa ISNARD,LR,3613,4.04,5.5,Battu
92,13,65652,87,1251,66990,22348,89338,Mme Marie-Josée PRETO,REC,770,0.86,1.17,Battu
92,13,65652,87,1251,66990,22348,89338,M. Mohamed TOUNSI,DVC,736,0.82,1.12,Battu
92,13,65652,87,1251,66990,22348,89338,Mme Agathe MARTIN,EXG,385,0.43,0.59,Battu
93,01,41817,290,484,42591,27325,69916,M. Éric COQUEREL,UG,27298,39.04,65.28,Elu
93,01,41817,290,484,42591,27325,69916,M. Jean-Pierre MONFILS,ENS,6185,8.85,14.79,Battu
93,01,41817,290,484,42591,27325,69916,M. Julien GRAZIOLI,RN,4803,6.87,11.49,Battu
93,01,41817,290,484,42591,27325,69916,M. François PEGUILLET,LR,1208,1.73,2.89,Battu
93,01,41817,290,484,42591,27325,69916,Mme Gersende LE MAIRE,ECO,878,1.26,2.1,Battu
93,01,41817,290,484,42591,27325,69916,M. Nabil BOUARD,DVD,618,0.88,1.48,Battu
93,01,41817,290,484,42591,27325,69916,M. Alain AUBRY,EXG,543,0.78,1.3,Battu
93,01,41817,290,484,42591,27325,69916,M. Paul UHALDE,EXG,204,0.29,0.49,Battu
93,01,41817,290,484,42591,27325,69916,M. Emmanuel BILONGO MAMBWENI,DIV,62,0.09,0.15,Battu
93,01,41817,290,484,42591,27325,69916,Mme Gaëll FALISZ,EXG,18,0.03,0.04,Battu
93,02,30716,257,453,31426,25456,56882,M. Stéphane PEU,UG,22055,38.77,71.8,Elu
93,02,30716,257,453,31426,25456,56882,M. Luc COLOMAS,RN,3628,6.38,11.81,Battu
93,02,30716,257,453,31426,25456,56882,Mme Samantha UK,ENS,2282,4.01,7.43,Battu
93,02,30716,257,453,31426,25456,56882,M. Anasse KAZIB,EXG,1128,1.98,3.67,Battu
93,02,30716,257,453,31426,25456,56882,M. Louis-Auxile MAILLARD,LR,798,1.4,2.6,Battu
93,02,30716,257,453,31426,25456,56882,Mme Agnès RENAUD,EXG,491,0.86,1.6,Battu
93,02,30716,257,453,31426,25456,56882,Mme Maki Théa MARQUAND,ECO,334,0.59,1.09,Battu
93,03,49537,386,785,50708,26770,77478,M. Thomas PORTES,UG,20648,26.65,41.68,Qualif
93,03,49537,386,785,50708,26770,77478,M. Denis CRETIN-GIELLY,RN,10539,13.6,21.28,Qualif
93,03,49537,386,785,50708,26770,77478,M. Eric ALLEMON,DVD,5681,7.33,11.47,Battu
93,03,49537,386,785,50708,26770,77478,M. Patrice ANATO,DVC,5521,7.13,11.15,Battu
93,03,49537,386,785,50708,26770,77478,Mme Stéphanie RICHARD,DVC,2710,3.5,5.47,Battu
93,03,49537,386,785,50708,26770,77478,Mme Djénéba DIABY,DVC,2452,3.16,4.95,Battu
93,03,49537,386,785,50708,26770,77478,M. Maxence BUTTEY,DVD,1146,1.48,2.31,Battu
93,03,49537,386,785,50708,26770,77478,Mme Maëlle GAUCHERAND,EXG,451,0.58,0.91,Battu
93,03,49537,386,785,50708,26770,77478,Mme Sarah Astrid DACKO,DIV,388,0.5,0.78,Battu
93,03,49537,386,785,50708,26770,77478,M. Gaspard NICOLLE,EXG,1,0,0,Battu
93,04,35399,291,811,36501,30936,67437,Mme Soumya BOUROUAHA,UG,15760,23.37,44.52,Qualif
93,04,35399,291,811,36501,30936,67437,M. Mohamed AWAD,FI,8462,12.55,23.9,Qualif
93,04,35399,291,811,36501,30936,67437,Mme Colette LÉVÊQUE,RN,5839,8.66,16.49,Battu
93,04,35399,291,811,36501,30936,67437,M. Hamza RABEHI,ENS,2429,3.6,6.86,Battu
93,04,35399,291,811,36501,30936,67437,M. Micaël VAZ,LR,1982,2.94,5.6,Battu
93,04,35399,291,811,36501,30936,67437,Mme Marlène LEY,EXG,344,0.51,0.97,Battu
93,04,35399,291,811,36501,30936,67437,M. Amirdine FAROUK,DIV,335,0.5,0.95,Battu
93,04,35399,291,811,36501,30936,67437,Mme Sonia ATTIG,DVG,105,0.16,0.3,Battu
93,04,35399,291,811,36501,30936,67437,M. Omar MIRALI,DIV,102,0.15,0.29,Battu
93,04,35399,291,811,36501,30936,67437,M. Matthieu BELIN,EXG,25,0.04,0.07,Battu
93,04,35399,291,811,36501,30936,67437,Mme Virginie POTTIER,DVD,16,0.02,0.05,Battu
93,05,36675,369,596,37640,28268,65908,M. Aly DIOUARA,UG,12141,18.42,33.1,Qualif
93,05,36675,369,596,37640,28268,65908,Mme Aude LAGARDE,UDI,9006,13.66,24.56,Qualif
93,05,36675,369,596,37640,28268,65908,Mme Raquel GARRIDO,DVG,8672,13.16,23.65,Qualif
93,05,36675,369,596,37640,28268,65908,M. Eric KOZELKO,RN,6382,9.68,17.4,Battu
93,05,36675,369,596,37640,28268,65908,M. Rodolphe FEGER,EXG,359,0.54,0.98,Battu
93,05,36675,369,596,37640,28268,65908,M. Markeins PIERRE,DVG,115,0.17,0.31,Battu
93,05,36675,369,596,37640,28268,65908,Mme Tatiana BOUTIGNON,DIV,0,0,0,Battu
93,05,36675,369,596,37640,28268,65908,Mme Hélène BALLOUHEY,EXG,0,0,0,Battu
93,06,35962,257,518,36737,24086,60823,M. Bastien LACHAUD,UG,25777,42.38,71.68,Elu
93,06,35962,257,518,36737,24086,60823,Mme Nathalie SACK,UDI,5014,8.24,13.94,Battu
93,06,35962,257,518,36737,24086,60823,Mme Nacéra SALHAOUI,RN,4175,6.86,11.61,Battu
93,06,35962,257,518,36737,24086,60823,Mme Nathalie ARTHAUD,EXG,996,1.64,2.77,Battu
93,07,54252,267,824,55343,28114,83457,M. Alexis CORBIÈRE,DVG,21802,26.12,40.19,Qualif
93,07,54252,267,824,55343,28114,83457,Mme Sabrina ALI-BENALI,UG,19740,23.65,36.39,Qualif
93,07,54252,267,824,55343,28114,83457,Mme Pauline BRETEAU,ENS,5458,6.54,10.06,Battu
93,07,54252,267,824,55343,28114,83457,Mme Françoise TROVA,RN,5254,6.3,9.68,Battu
93,07,54252,267,824,55343,28114,83457,M. Antoine TOCHE,DVD,713,0.85,1.31,Battu
93,07,54252,267,824,55343,28114,83457,M. Eric VERHAEGHE,DVC,518,0.62,0.95,Battu
93,07,54252,267,824,55343,28114,83457,Mme Aurélie JOCHAUD,EXG,344,0.41,0.63,Battu
93,07,54252,267,824,55343,28114,83457,M. Yannick DUTERTE,EXG,180,0.22,0.33,Battu
93,07,54252,267,824,55343,28114,83457,Mme Elsa CAUDRON,EXG,165,0.2,0.3,Battu
93,07,54252,267,824,55343,28114,83457,M. Sebastien ATLANI,DIV,78,0.09,0.14,Battu
93,08,38934,201,973,40108,22608,62716,Mme Fatiha KELOUA HACHI,UG,19193,30.6,49.3,Qualif
93,08,38934,201,973,40108,22608,62716,M. Sébastien JOLIVET,RN,9291,14.81,23.86,Qualif
93,08,38934,201,973,40108,22608,62716,M. Didier FORT,DVD,5350,8.53,13.74,Battu
93,08,38934,201,973,40108,22608,62716,M. Franck YONBOUE,LR,3844,6.13,9.87,Battu
93,08,38934,201,973,40108,22608,62716,M. Sylvio VALENTE,REC,634,1.01,1.63,Battu
93,08,38934,201,973,40108,22608,62716,M. Grégory TOBEILEM,EXG,509,0.81,1.31,Battu
93,08,38934,201,973,40108,22608,62716,M. Ntela BARDAI,EXD,86,0.14,0.22,Battu
93,08,38934,201,973,40108,22608,62716,Mme Hélène DUPUY,EXG,27,0.04,0.07,Battu
93,09,47371,319,696,48386,27841,76227,Mme Aurélie TROUVÉ,UG,29935,39.27,63.19,Elu
93,09,47371,319,696,48386,27841,76227,Mme Clara BOURASSIN,RN,7156,9.39,15.11,Battu
93,09,47371,319,696,48386,27841,76227,Mme Manon CHAUMETTE,ENS,7119,9.34,15.03,Battu
93,09,47371,319,696,48386,27841,76227,M. Robenson PIERRE,LR,2073,2.72,4.38,Battu
93,09,47371,319,696,48386,27841,76227,M. Jean-Paul BUROT,EXG,681,0.89,1.44,Battu
93,09,47371,319,696,48386,27841,76227,Mme Christel KEISER,EXG,407,0.53,0.86,Battu
93,10,40460,272,643,41375,26608,67983,Mme Nadège ABOMANGOLI,UG,21282,31.3,52.6,Elu
93,10,40460,272,643,41375,26608,67983,Mme Monique TROVA,RN,7409,10.9,18.31,Battu
93,10,40460,272,643,41375,26608,67983,M. Alain RAMADIER,LR,7129,10.49,17.62,Battu
93,10,40460,272,643,41375,26608,67983,M. Martial MEYONGO AMOUGOU,ENS,3321,4.89,8.21,Battu
93,10,40460,272,643,41375,26608,67983,M. Gaëtan MINARDI,EXG,563,0.83,1.39,Battu
93,10,40460,272,643,41375,26608,67983,M. Praince Germain LOUBOTA,REC,381,0.56,0.94,Battu
93,10,40460,272,643,41375,26608,67983,M. Ahmed EL OUAFI,DIV,291,0.43,0.72,Battu
93,10,40460,272,643,41375,26608,67983,Mme Amèle BENTAHAR,DIV,84,0.12,0.21,Battu
93,11,35452,306,570,36328,28289,64617,Mme Clémentine AUTAIN,UG,22209,34.37,62.65,Elu
93,11,35452,306,570,36328,28289,64617,Mme Renée JOLY,RN,6694,10.36,18.88,Battu
93,11,35452,306,570,36328,28289,64617,Mme Fayza BASINI,ENS,3702,5.73,10.44,Battu
93,11,35452,306,570,36328,28289,64617,M. Max MARAN,LR,1658,2.57,4.68,Battu
93,11,35452,306,570,36328,28289,64617,Mme Kahina NÄIT-KACI,DVD,801,1.24,2.26,Battu
93,11,35452,306,570,36328,28289,64617,Mme Charlotte SÉCHET,EXG,388,0.6,1.09,Battu
93,11,35452,306,570,36328,28289,64617,M. Lucien BELZANE,EXG,0,0,0,Battu
93,12,38937,260,650,39847,26527,66374,M. Jérôme LEGAVRE,UG,17566,26.47,45.11,Qualif
93,12,38937,260,650,39847,26527,66374,M. Jean-François PERIER,RN,10140,15.28,26.04,Qualif
93,12,38937,260,650,39847,26527,66374,M. Xavier LEMOINE,DVD,5016,7.56,12.88,Battu
93,12,38937,260,650,39847,26527,66374,Mme Virginie ROITMAN,ENS,4893,7.37,12.57,Battu
93,12,38937,260,650,39847,26527,66374,M. Francis DIJOS,REC,546,0.82,1.4,Battu
93,12,38937,260,650,39847,26527,66374,Mme Amal AISSAOUI,EXG,503,0.76,1.29,Battu
93,12,38937,260,650,39847,26527,66374,M. Dominique VINCENOT,EXG,273,0.41,0.7,Battu
93,12,38937,260,650,39847,26527,66374,M. Serjan KIRMA,DIV,0,0,0,Battu
93,12,38937,260,650,39847,26527,66374,M. Didier MARTINOT,EXG,0,0,0,Battu
94,01,60471,276,665,61412,24528,85940,M. Lyes LOUFFOK,UG,19974,23.24,33.03,Qualif
94,01,60471,276,665,61412,24528,85940,M. Sylvain BERRIOS,DVD,16916,19.68,27.97,Qualif
94,01,60471,276,665,61412,24528,85940,M. Frédéric DESCROZAILLE,ENS,11232,13.07,18.57,Qualif
94,01,60471,276,665,61412,24528,85940,Mme Anne-Gaëlle SABOURIN,RN,11100,12.92,18.36,Qualif
94,01,60471,276,665,61412,24528,85940,M. Ludovic MOREL,REC,682,0.79,1.13,Battu
94,01,60471,276,665,61412,24528,85940,Mme Valérie DE PIERREPONT,EXG,567,0.66,0.94,Battu
94,01,60471,276,665,61412,24528,85940,Mme Hélène CAVAT,EXG,0,0,0,Battu
94,02,40896,378,600,41874,23503,65377,Mme Clémence GUETTÉ,UG,22494,34.41,55,Elu
94,02,40896,378,600,41874,23503,65377,M. Antoine GHAYE,RN,7153,10.94,17.49,Battu
94,02,40896,378,600,41874,23503,65377,M. Mehmet CEYLAN,ENS,6559,10.03,16.04,Battu
94,02,40896,378,600,41874,23503,65377,M. Michel SASPORTAS,LR,2103,3.22,5.14,Battu
94,02,40896,378,600,41874,23503,65377,Mme Patricia FOFFÉ,ECO,1236,1.89,3.02,Battu
94,02,40896,378,600,41874,23503,65377,Mme Sabrina PRUVOT,EXG,546,0.84,1.34,Battu
94,02,40896,378,600,41874,23503,65377,M. Gérard CRUZILLE,REC,514,0.79,1.26,Battu
94,02,40896,378,600,41874,23503,65377,Mme Manon HALLER,EXG,291,0.45,0.71,Battu
94,02,40896,378,600,41874,23503,65377,Mme Clémence BOUTARIN,EXG,0,0,0,Battu
94,03,45740,385,1249,47374,26998,74372,M. Louis BOYARD,UG,19290,25.94,42.17,Qualif
94,03,45740,385,1249,47374,26998,74372,M. Arnaud BARBOTIN,UXD,12491,16.8,27.31,Qualif
94,03,45740,385,1249,47374,26998,74372,M. Loïc SIGNOR,ENS,10871,14.62,23.77,Qualif
94,03,45740,385,1249,47374,26998,74372,Mme Géraldine TELLE,DVC,870,1.17,1.9,Battu
94,03,45740,385,1249,47374,26998,74372,M. Lucien NOAILE,EXG,651,0.88,1.42,Battu
94,03,45740,385,1249,47374,26998,74372,Mme Frédérique PONCET,REC,650,0.87,1.42,Battu
94,03,45740,385,1249,47374,26998,74372,M. Noël AGOSSA,DVC,602,0.81,1.32,Battu
94,03,45740,385,1249,47374,26998,74372,M. Emmanuelly GOUGOUGNAN-ZADIGUE,DSV,315,0.42,0.69,Battu
94,04,49989,325,898,51212,23671,74883,M. Adel AMARA,UG,16505,22.04,33.02,Qualif
94,04,49989,325,898,51212,23671,74883,Mme Maud PETIT,ENS,15287,20.41,30.58,Qualif
94,04,49989,325,898,51212,23671,74883,M. Alain PHILIPPET,RN,13474,17.99,26.95,Qualif
94,04,49989,325,898,51212,23671,74883,M. Bernard CHAUSSEGROS,DVD,1292,1.73,2.58,Battu
94,04,49989,325,898,51212,23671,74883,Mme Marie-Odile PERRU,DVC,820,1.1,1.64,Battu
94,04,49989,325,898,51212,23671,74883,Mme Soraya BENSLIMANE,DSV,624,0.83,1.25,Battu
94,04,49989,325,898,51212,23671,74883,M. Michaël BOHBOT,REC,594,0.79,1.19,Battu
94,04,49989,325,898,51212,23671,74883,Mme Brigitte MOULIN,EXG,557,0.74,1.11,Battu
94,04,49989,325,898,51212,23671,74883,M. Maxence SOBRAL,DVD,543,0.73,1.09,Battu
94,04,49989,325,898,51212,23671,74883,M. Jean DAMBREVILLE,DVG,293,0.39,0.59,Battu
94,05,60786,316,1075,62177,29497,91674,M. Mathieu LEFEVRE,ENS,23416,25.54,38.52,Qualif
94,05,60786,316,1075,62177,29497,91674,M. Julien LEGER,UG,22657,24.71,37.27,Qualif
94,05,60786,316,1075,62177,29497,91674,Mme Isabelle HUGUENIN-RICHARD,RN,12401,13.53,20.4,Qualif
94,05,60786,316,1075,62177,29497,91674,Mme Simone BENOUADAH,REC,853,0.93,1.4,Battu
94,05,60786,316,1075,62177,29497,91674,Mme Catherine MOLINARI,DVC,717,0.78,1.18,Battu
94,05,60786,316,1075,62177,29497,91674,M. François JOSLIN,EXG,563,0.61,0.93,Battu
94,05,60786,316,1075,62177,29497,91674,Mme Maeva Sara ANGELE,DVC,179,0.2,0.29,Battu
94,06,60097,287,608,60992,21439,82431,Mme May BOUHADA,UG,24417,29.62,40.63,Qualif
94,06,60097,287,608,60992,21439,82431,M. Guillaume GOUFFIER VALENTE,ENS,22464,27.25,37.38,Qualif
94,06,60097,287,608,60992,21439,82431,Mme Martina GABELICA,RN,8347,10.13,13.89,Battu
94,06,60097,287,608,60992,21439,82431,M. Victor GAONACH,DVD,2325,2.82,3.87,Battu
94,06,60097,287,608,60992,21439,82431,M. Rémy LONGETTI,REC,1099,1.33,1.83,Battu
94,06,60097,287,608,60992,21439,82431,M. Tony RENAULT,ECO,979,1.19,1.63,Battu
94,06,60097,287,608,60992,21439,82431,Mme Véronique HUNAUT,EXG,290,0.35,0.48,Battu
94,06,60097,287,608,60992,21439,82431,Mme Murielle MORAND,EXG,176,0.21,0.29,Battu
94,07,42927,278,716,43921,22869,66790,Mme Rachel KEKE,UG,18736,28.05,43.65,Qualif
94,07,42927,278,716,43921,22869,66790,M. Vincent JEANBRUN,LR,14869,22.26,34.64,Qualif
94,07,42927,278,716,43921,22869,66790,M. Claude LEDION,RN,8111,12.14,18.89,Battu
94,07,42927,278,716,43921,22869,66790,Mme Claire MAURY,EXG,623,0.93,1.45,Battu
94,07,42927,278,716,43921,22869,66790,Mme Florence DE LA RUELLE,REC,493,0.74,1.15,Battu
94,07,42927,278,716,43921,22869,66790,Mme Rachel CASTIN,EXD,95,0.14,0.22,Battu
94,08,56020,230,528,56778,20262,77040,M. Michel HERBILLON,LR,24722,32.09,44.13,Qualif
94,08,56020,230,528,56778,20262,77040,M. Joao MARTINS PEREIRA,UG,20658,26.81,36.88,Qualif
94,08,56020,230,528,56778,20262,77040,M. Raphaël TURPIN,RN,9085,11.79,16.22,Battu
94,08,56020,230,528,56778,20262,77040,M. Olivier BUCLIN,REC,1009,1.31,1.8,Battu
94,08,56020,230,528,56778,20262,77040,Mme Amandine CHEYNS,EXG,546,0.71,0.97,Battu
94,09,33650,284,469,34403,20042,54445,Mme Isabelle SANTIAGO,UG,19548,35.9,58.09,Elu
94,09,33650,284,469,34403,20042,54445,Mme Wenqi CUI,RN,6083,11.17,18.08,Battu
94,09,33650,284,469,34403,20042,54445,Mme Noémie AMIROU,ENS,4964,9.12,14.75,Battu
94,09,33650,284,469,34403,20042,54445,M. Jérôme AUBERTIN,LR,1353,2.49,4.02,Battu
94,09,33650,284,469,34403,20042,54445,M. Christophe JAUBERT,ECO,730,1.34,2.17,Battu
94,09,33650,284,469,34403,20042,54445,Mme Marie VIEIRA,EXG,353,0.65,1.05,Battu
94,09,33650,284,469,34403,20042,54445,M. Ambroise RAMASSAMY,REC,353,0.65,1.05,Battu
94,09,33650,284,469,34403,20042,54445,Mme Véronique DUCANDAS,EXG,184,0.34,0.55,Battu
94,09,33650,284,469,34403,20042,54445,Mme Sophie ORTOLE,EXD,82,0.15,0.24,Battu
94,09,33650,284,469,34403,20042,54445,M. Luc CHEVALLIER,EXG,0,0,0,Battu
94,10,43085,381,664,44130,22498,66628,Mme Mathilde PANOT,UG,25536,38.33,59.27,Elu
94,10,43085,381,664,44130,22498,66628,Mme Shannon SEBAN,ENS,7977,11.97,18.51,Battu
94,10,43085,381,664,44130,22498,66628,Mme Elise LIN,RN,6408,9.62,14.87,Battu
94,10,43085,381,664,44130,22498,66628,Mme Coralie BARBERON,ECO,1788,2.68,4.15,Battu
94,10,43085,381,664,44130,22498,66628,Mme Christine LICHTENAUER,EXG,491,0.74,1.14,Battu
94,10,43085,381,664,44130,22498,66628,Mme Charlotte SEVESTRE,REC,469,0.7,1.09,Battu
94,10,43085,381,664,44130,22498,66628,Mme Selma LABIB,EXG,212,0.32,0.49,Battu
94,10,43085,381,664,44130,22498,66628,M. Farid AÏSSAOUI,DIV,204,0.31,0.47,Battu
94,11,42622,217,587,43426,22634,66060,Mme Sophie TAILLÉ-POLIAN,UG,24447,37.01,57.36,Elu
94,11,42622,217,587,43426,22634,66060,Mme Nathalie PICOT,ENS,8494,12.86,19.93,Battu
94,11,42622,217,587,43426,22634,66060,Mme Sylvie BOUCHOT,RN,6093,9.22,14.3,Battu
94,11,42622,217,587,43426,22634,66060,M. Cédric RIVET-SOW,DVD,1504,2.28,3.53,Battu
94,11,42622,217,587,43426,22634,66060,M. Charles MARIAUD,UDI,1167,1.77,2.74,Battu
94,11,42622,217,587,43426,22634,66060,Mme Lydie COUSTY,REC,452,0.68,1.06,Battu
94,11,42622,217,587,43426,22634,66060,Mme Christine SAMSON,EXG,319,0.48,0.75,Battu
94,11,42622,217,587,43426,22634,66060,M. Sébastien SUGRANES,EXG,146,0.22,0.34,Battu
95,01,55941,386,1147,57474,26542,84016,Mme Anne SICARD,RN,18823,22.4,33.65,Qualif
95,01,55941,386,1147,57474,26542,84016,M. Maximillien JULES-ARTHUR,UG,17230,20.51,30.8,Qualif
95,01,55941,386,1147,57474,26542,84016,Mme Émilie CHANDLER,ENS,14244,16.95,25.46,Qualif
95,01,55941,386,1147,57474,26542,84016,M. Michel RICHARD,LR,3468,4.13,6.2,Battu
95,01,55941,386,1147,57474,26542,84016,Mme Barbara GÉHAN,EXG,826,0.98,1.48,Battu
95,01,55941,386,1147,57474,26542,84016,M. Lionel LESSAINT,DSV,755,0.9,1.35,Battu
95,01,55941,386,1147,57474,26542,84016,Mme Laure DE GARILS,REC,574,0.68,1.03,Battu
95,01,55941,386,1147,57474,26542,84016,M. Sami LAH,DIV,21,0.02,0.04,Battu
95,01,55941,386,1147,57474,26542,84016,Mme Ethel SOUSSI,EXG,0,0,0,Battu
95,02,51453,370,866,52689,26092,78781,Mme Ayda HADIZADEH,UG,17221,21.86,33.47,Qualif
95,02,51453,370,866,52689,26092,78781,Mme Nadejda REMY,RN,15544,19.73,30.21,Qualif
95,02,51453,370,866,52689,26092,78781,M. Guillaume VUILLETET,ENS,13044,16.56,25.35,Qualif
95,02,51453,370,866,52689,26092,78781,M. Frédéric PAIN,LR,3214,4.08,6.25,Battu
95,02,51453,370,866,52689,26092,78781,M. Brahim OUBAIROUK,DIV,818,1.04,1.59,Battu
95,02,51453,370,866,52689,26092,78781,M. Alvin IVANAJ,DIV,621,0.79,1.21,Battu
95,02,51453,370,866,52689,26092,78781,M. Philippe CHANZY,REC,529,0.67,1.03,Battu
95,02,51453,370,866,52689,26092,78781,M. Éric CASSAN,EXG,456,0.58,0.89,Battu
95,02,51453,370,866,52689,26092,78781,Mme Danièle LESSAINT,DSV,6,0.01,0.01,Battu
95,02,51453,370,866,52689,26092,78781,M. Stephane GAULTIER,EXG,0,0,0,Battu
95,03,63827,374,930,65131,31175,96306,M. Emmanuel MAUREL,UG,22742,23.61,35.63,Qualif
95,03,63827,374,930,65131,31175,96306,Mme Kimberley LELAIDIER,RN,17608,18.28,27.59,Qualif
95,03,63827,374,930,65131,31175,96306,Mme Cécile RILHAC,ENS,15013,15.59,23.52,Qualif
95,03,63827,374,930,65131,31175,96306,Mme Laetitia VINCENT,LR,4816,5,7.55,Battu
95,03,63827,374,930,65131,31175,96306,Mme Samira HERBAL,ECO,1290,1.34,2.02,Battu
95,03,63827,374,930,65131,31175,96306,Mme Laetitia GUÉBIN,DIV,1046,1.09,1.64,Battu
95,03,63827,374,930,65131,31175,96306,M. Alexandre SIMONNOT,REC,837,0.87,1.31,Battu
95,03,63827,374,930,65131,31175,96306,M. Juan MUNOZ,EXG,468,0.49,0.73,Battu
95,03,63827,374,930,65131,31175,96306,M. Daniel BLASER,EXG,7,0.01,0.01,Battu
95,03,63827,374,930,65131,31175,96306,Mme Samira BELMOKHTAR,DVG,0,0,0,Battu
95,04,50492,262,728,51482,24780,76262,Mme Karine LACOUTURE,UG,17498,22.94,34.65,Qualif
95,04,50492,262,728,51482,24780,76262,Mme Naïma MOUTCHOU,ENS,14084,18.47,27.89,Qualif
95,04,50492,262,728,51482,24780,76262,M. Sébastien MEURANT,UXD,13238,17.36,26.22,Qualif
95,04,50492,262,728,51482,24780,76262,M. Inthone RODSPHON,LR,3003,3.94,5.95,Battu
95,04,50492,262,728,51482,24780,76262,M. Grégory BERTHAULT,ECO,2132,2.8,4.22,Battu
95,04,50492,262,728,51482,24780,76262,Mme Marie-Françoise L'HOMMEDET,EXG,485,0.64,0.96,Battu
95,04,50492,262,728,51482,24780,76262,M. Robin DURAND,DIV,52,0.07,0.1,Battu
95,04,50492,262,728,51482,24780,76262,M. Antonin MARTIN,EXG,0,0,0,Battu
95,05,41616,329,631,42576,28267,70843,M. Paul VANNIER,UG,23308,32.9,56.01,Elu
95,05,41616,329,631,42576,28267,70843,M. Quentin HOARAU,RN,7784,10.99,18.7,Battu
95,05,41616,329,631,42576,28267,70843,Mme Fatima LILIYAJE,ENS,5389,7.61,12.95,Battu
95,05,41616,329,631,42576,28267,70843,M. Boualem MEZIANE,LR,3170,4.47,7.62,Battu
95,05,41616,329,631,42576,28267,70843,M. Dominique MARIETTE,EXG,558,0.79,1.34,Battu
95,05,41616,329,631,42576,28267,70843,Mme Dominique LESUEUR,ECO,555,0.78,1.33,Battu
95,05,41616,329,631,42576,28267,70843,M. Gilbert PHAM,UDI,412,0.58,0.99,Battu
95,05,41616,329,631,42576,28267,70843,Mme Thès BALEUR,DIV,251,0.35,0.6,Battu
95,05,41616,329,631,42576,28267,70843,M. Jean-Baptiste POIAGHI,EXG,189,0.27,0.45,Battu
95,06,49435,260,626,50321,25432,75753,Mme Gabrielle CATHALA,UG,18603,24.56,37.63,Qualif
95,06,49435,260,626,50321,25432,75753,Mme Estelle FOLEST,ENS,12745,16.82,25.78,Qualif
95,06,49435,260,626,50321,25432,75753,Mme Annika BRUNA,RN,10911,14.4,22.07,Qualif
95,06,49435,260,626,50321,25432,75753,Mme Audrey GUILBAUD,LR,3737,4.93,7.56,Battu
95,06,49435,260,626,50321,25432,75753,M. Loïc ELÉLOUÉ-VALMAR,REG,1049,1.38,2.12,Battu
95,06,49435,260,626,50321,25432,75753,M. Emmanuel MIKAEL,DVC,910,1.2,1.84,Battu
95,06,49435,260,626,50321,25432,75753,M. Jean Bernard LASMARRIGUES,REC,683,0.9,1.38,Battu
95,06,49435,260,626,50321,25432,75753,M. Christophe CELESTIN,DVC,427,0.56,0.86,Battu
95,06,49435,260,626,50321,25432,75753,Mme Agnès REINMANN,EXG,370,0.49,0.75,Battu
95,06,49435,260,626,50321,25432,75753,Mme Marine DAGEVILLE,EXG,0,0,0,Battu
95,07,44271,294,712,45277,23262,68539,M. Romain ESKENAZI,UG,16797,24.51,37.94,Qualif
95,07,44271,294,712,45277,23262,68539,M. David QUENTIN,RN,12065,17.6,27.25,Qualif
95,07,44271,294,712,45277,23262,68539,M. Dominique DA SILVA,ENS,10241,14.94,23.13,Qualif
95,07,44271,294,712,45277,23262,68539,M. Jean-Pierre YALCIN,LR,3891,5.68,8.79,Battu
95,07,44271,294,712,45277,23262,68539,Mme Virginie VIEVILLE,REC,696,1.02,1.57,Battu
95,07,44271,294,712,45277,23262,68539,Mme Valérie SUAREZ,EXG,578,0.84,1.31,Battu
95,07,44271,294,712,45277,23262,68539,Mme Marie-Christine CHASTAING,DSV,3,0,0.01,Battu
95,07,44271,294,712,45277,23262,68539,M. Didier ARNAL,DIV,0,0,0,Battu
95,07,44271,294,712,45277,23262,68539,M. Aurélien GAVOIS,EXG,0,0,0,Battu
95,07,44271,294,712,45277,23262,68539,Mme Linda UZAN,DIV,0,0,0,Battu
95,08,29838,762,593,31193,24573,55766,M. Carlos Martens BILONGO,UG,17386,31.18,58.27,Elu
95,08,29838,762,593,31193,24573,55766,M. Thierry FOUCHEREAU,RN,5840,10.47,19.57,Battu
95,08,29838,762,593,31193,24573,55766,M. Ramzi ZINAOUI,UDI,3293,5.91,11.04,Battu
95,08,29838,762,593,31193,24573,55766,M. Patrick ANGREVIER,DVD,1961,3.52,6.57,Battu
95,08,29838,762,593,31193,24573,55766,Mme Luisa VARELA,REC,503,0.9,1.69,Battu
95,08,29838,762,593,31193,24573,55766,Mme Malika KHERFI,DVC,451,0.81,1.51,Battu
95,08,29838,762,593,31193,24573,55766,M. Rémi GAJDOS,EXG,404,0.72,1.35,Battu
95,08,29838,762,593,31193,24573,55766,M. Jean-Baptiste TONDU,EXG,0,0,0,Battu
95,09,42126,331,711,43168,28446,71614,M. Arnaud LE GALL,UG,17157,23.96,40.73,Qualif
95,09,42126,331,711,43168,28446,71614,Mme Agnès MARION,RN,12872,17.97,30.56,Qualif
95,09,42126,331,711,43168,28446,71614,Mme Elisa DEMIR,ENS,6149,8.59,14.6,Battu
95,09,42126,331,711,43168,28446,71614,M. Anthony ARCIERO,LR,4789,6.69,11.37,Battu
95,09,42126,331,711,43168,28446,71614,Mme Danièle HANRYON,EXG,621,0.87,1.47,Battu
95,09,42126,331,711,43168,28446,71614,M. David SAID,REC,381,0.53,0.9,Battu
95,09,42126,331,711,43168,28446,71614,Mme Nsimba WASSA,DIV,157,0.22,0.37,Battu
95,09,42126,331,711,43168,28446,71614,M. Mohamed NAJIB,DIV,0,0,0,Battu
95,09,42126,331,711,43168,28446,71614,Mme Vanessa RONCHINI,EXG,0,0,0,Battu
95,10,42442,237,906,43585,23188,66773,M. Aurélien TACHÉ,UG,18306,27.42,43.13,Qualif
95,10,42442,237,906,43585,23188,66773,Mme Lisbeth MACÉ,RN,9667,14.48,22.78,Qualif
95,10,42442,237,906,43585,23188,66773,Mme Sonia KRIMI,ENS,8129,12.17,19.15,Battu
95,10,42442,237,906,43585,23188,66773,Mme Edwina ÉTORÉ-MANIKA,LR,4249,6.36,10.01,Battu
95,10,42442,237,906,43585,23188,66773,M. Albert SAINT-JEAN,UDI,1107,1.66,2.61,Battu
95,10,42442,237,906,43585,23188,66773,M. Christophe FLAUX,EXG,489,0.73,1.15,Battu
95,10,42442,237,906,43585,23188,66773,Mme Souade DE LA FAYE,DSV,488,0.73,1.15,Battu
95,10,42442,237,906,43585,23188,66773,M. Jean CAILLOT,EXG,7,0.01,0.02,Battu
97,01,23430,703,529,24662,51095,75757,M. Olivier SERVA,DVG,12042,15.9,51.4,Qualif
97,01,23430,703,529,24662,51095,75757,Mme Chantal LERUS,DVG,2965,3.91,12.65,Qualif
97,01,23430,703,529,24662,51095,75757,M. Marvyn MARTOL,SOC,2531,3.34,10.8,Battu
97,01,23430,703,529,24662,51095,75757,M. Tarius ROYER,RN,2252,2.97,9.61,Battu
97,01,23430,703,529,24662,51095,75757,Mme Laurence MAQUIABA,REG,1583,2.09,6.76,Battu
97,01,23430,703,529,24662,51095,75757,M. Alix NABAJOTH,DVG,1102,1.45,4.7,Battu
97,01,23430,703,529,24662,51095,75757,Mme Danielle DIAKOK,EXG,336,0.44,1.43,Battu
97,01,23430,703,529,24662,51095,75757,M. Dieudonné MBALA MBALA,DIV,241,0.32,1.03,Battu
97,01,23430,703,529,24662,51095,75757,M. Rudy Fiacre FARO,LR,197,0.26,0.84,Battu
97,01,23430,703,529,24662,51095,75757,M. Tony REBUS,DIV,104,0.14,0.44,Battu
97,01,23430,703,529,24662,51095,75757,Mme Rosemary ARMANTRADING,REC,77,0.1,0.33,Battu
97,02,26380,950,865,28195,60513,88708,M. Christian BAPTISTE,DVG,10903,12.29,41.33,Qualif
97,02,26380,950,865,28195,60513,88708,M. Laurent PETIT,RN,4563,5.14,17.3,Qualif
97,02,26380,950,865,28195,60513,88708,M. Blaise ALDO,DVD,2291,2.58,8.68,Battu
97,02,26380,950,865,28195,60513,88708,Mme Priscilla SYLVESTRE,DIV,1895,2.14,7.18,Battu
97,02,26380,950,865,28195,60513,88708,M. Ludovic TOLASSY,REG,1761,1.99,6.68,Battu
97,02,26380,950,865,28195,60513,88708,M. Steve SALIM,DIV,1685,1.9,6.39,Battu
97,02,26380,950,865,28195,60513,88708,M. Michel TOLA,DVG,1551,1.75,5.88,Battu
97,02,26380,950,865,28195,60513,88708,M. Patrick Marcellin GALAS,DVC,698,0.79,2.65,Battu
97,02,26380,950,865,28195,60513,88708,M. José AYASSAMI,DIV,324,0.37,1.23,Battu
97,02,26380,950,865,28195,60513,88708,M. Steeve CIREDERF-ROUYAR,UG,226,0.25,0.86,Battu
97,02,26380,950,865,28195,60513,88708,Mme Roseline CHATELOT,DIV,182,0.21,0.69,Battu
97,02,26380,950,865,28195,60513,88708,Mme Paméla POMMIER,DIV,173,0.2,0.66,Battu
97,02,26380,950,865,28195,60513,88708,M. Raymond MOLIA,DIV,126,0.14,0.48,Battu
97,02,26380,950,865,28195,60513,88708,M. Moïse AYASSAMY,DVG,2,0,0.01,Battu
97,03,29474,766,694,30934,54832,85766,M. Max MATHIASIN,DVG,10672,12.44,36.21,Qualif
97,03,29474,766,694,30934,54832,85766,M. Rody TOLASSY,RN,7635,8.9,25.9,Qualif
97,03,29474,766,694,30934,54832,85766,M. Nicolas CITADELLE,SOC,4361,5.08,14.8,Battu
97,03,29474,766,694,30934,54832,85766,M. Fred DESHAYES,DVG,3381,3.94,11.47,Battu
97,03,29474,766,694,30934,54832,85766,M. Eric CORIOLAN,REG,1644,1.92,5.58,Battu
97,03,29474,766,694,30934,54832,85766,M. Christopher PETITFOND,DVC,601,0.7,2.04,Battu
97,03,29474,766,694,30934,54832,85766,Mme Sidjie ESDRAS,EXG,545,0.64,1.85,Battu
97,03,29474,766,694,30934,54832,85766,M. Bernard ABDOUL-MANINROUDINE,DIV,271,0.32,0.92,Battu
97,03,29474,766,694,30934,54832,85766,Mme Christèle PIGNAC,REC,191,0.22,0.65,Battu
97,03,29474,766,694,30934,54832,85766,M. Francis LALANNE,DIV,173,0.2,0.59,Battu
97,04,21792,863,582,23237,45493,68730,M. Elie CALIFER,SOC,12617,18.36,57.9,Qualif
97,04,21792,863,582,23237,45493,68730,Mme Jennifer LINON,DVC,4763,6.93,21.86,Qualif
97,04,21792,863,582,23237,45493,68730,Mme Lydie Marie MONTHOUËL,RN,2570,3.74,11.79,Battu
97,04,21792,863,582,23237,45493,68730,M. Jean-Marie NOMERTIN,EXG,1396,2.03,6.41,Battu
97,04,21792,863,582,23237,45493,68730,Mme Claudia BOUCHER,DIV,225,0.33,1.03,Battu
97,04,21792,863,582,23237,45493,68730,Mme Paola PLANTIER,REC,221,0.32,1.01,Battu
97,01,23151,615,768,24534,55794,80328,M. Jiovanny WILLIAM,REG,13095,16.3,56.56,Qualif
97,01,23151,615,768,24534,55794,80328,M. Philippe EDMOND-MARIETTE,REG,3106,3.87,13.42,Qualif
97,01,23151,615,768,24534,55794,80328,M. Alain-Claude LAGIER,DVG,2690,3.35,11.62,Battu
97,01,23151,615,768,24534,55794,80328,M. Cédric CRAMPON,RN,2312,2.88,9.99,Battu
97,01,23151,615,768,24534,55794,80328,M. Gabriel JEAN-MARIE,EXG,665,0.83,2.87,Battu
97,01,23151,615,768,24534,55794,80328,M. Yann MIEVILLY,ECO,599,0.75,2.59,Battu
97,01,23151,615,768,24534,55794,80328,M. Sylvain HOCHE,DVD,584,0.73,2.52,Battu
97,01,23151,615,768,24534,55794,80328,M. Fabrice FIARI,DIV,100,0.12,0.43,Battu
97,02,24877,641,778,26296,53379,79675,M. Marcellin NADEAU,REG,12017,15.08,48.31,Qualif
97,02,24877,641,778,26296,53379,79675,M. Yan MONPLAISIR,DVD,6732,8.45,27.06,Qualif
97,02,24877,641,778,26296,53379,79675,M. Juvénal REMIR,RN,2614,3.28,10.51,Battu
97,02,24877,641,778,26296,53379,79675,M. Christian RAPHA,DVD,1888,2.37,7.59,Battu
97,02,24877,641,778,26296,53379,79675,M. Alexandre VENTADOUR,DVG,1626,2.04,6.54,Battu
97,03,17774,417,585,18776,41482,60258,M. Johnny HAJJAR,DVG,6626,11,37.28,Qualif
97,03,17774,417,585,18776,41482,60258,Mme Beatrice BELLAY,SOC,4489,7.45,25.26,Qualif
97,03,17774,417,585,18776,41482,60258,M. Francis CAROLE,REG,2617,4.34,14.72,Battu
97,03,17774,417,585,18776,41482,60258,M. Max FERRATY,RN,1684,2.79,9.47,Battu
97,03,17774,417,585,18776,41482,60258,Mme Nathalie JOS,REG,1010,1.68,5.68,Battu
97,03,17774,417,585,18776,41482,60258,Mme Frédérique DISPAGNE,DVG,624,1.04,3.51,Battu
97,03,17774,417,585,18776,41482,60258,Mme Mélanie SULIO,EXG,363,0.6,2.04,Battu
97,03,17774,417,585,18776,41482,60258,M. Emmanuel GRANIER,DVD,361,0.6,2.03,Battu
97,04,24384,471,601,25456,58966,84422,M. Jean-Philippe NILOR,REG,15405,18.25,63.18,Qualif
97,04,24384,471,601,25456,58966,84422,M. Grégory Michel ROY-LARENTRY,RN,2408,2.85,9.88,Qualif
97,04,24384,471,601,25456,58966,84422,M. Philippe PETIT,UDI,2316,2.74,9.5,Battu
97,04,24384,471,601,25456,58966,84422,M. Louis BOUTRIN,ECO,1538,1.82,6.31,Battu
97,04,24384,471,601,25456,58966,84422,Mme Aude GOUSSARD,REG,1294,1.53,5.31,Battu
97,04,24384,471,601,25456,58966,84422,Mme Yvette GALOT,DVG,824,0.98,3.38,Battu
97,04,24384,471,601,25456,58966,84422,Mme Karine THERESE,ECO,599,0.71,2.46,Battu
97,01,20541,245,314,21100,38145,59245,M. Jean-Victor CASTOR,REG,12895,21.77,62.78,Qualif
97,01,20541,245,314,21100,38145,59245,M. Boris CHONG SIT,DVD,3308,5.58,16.1,Qualif
97,01,20541,245,314,21100,38145,59245,Mme Yvane GOUA,REG,2158,3.64,10.51,Battu
97,01,20541,245,314,21100,38145,59245,M. Olivier TAOUMI,RN,1916,3.23,9.33,Battu
97,01,20541,245,314,21100,38145,59245,M. Jean-Yves MIRAKOFF,DVG,264,0.45,1.29,Battu
97,02,13796,270,296,14362,35293,49655,M. Davy RIMANE,REG,8307,16.73,60.21,Qualif
97,02,13796,270,296,14362,35293,49655,Mme Sophie CHARLES,DVC,3516,7.08,25.49,Qualif
97,02,13796,270,296,14362,35293,49655,M. Jean-Philippe DOLOR,DVC,1110,2.24,8.05,Battu
97,02,13796,270,296,14362,35293,49655,M. Aldo NEMAN,DVG,594,1.2,4.31,Battu
97,02,13796,270,296,14362,35293,49655,M. Sébastien CAUGANT,EXG,269,0.54,1.95,Battu
97,01,41482,809,1134,43425,45122,88547,M. Philippe NAILLET,UG,19186,21.67,46.25,Qualif
97,01,41482,809,1134,43425,45122,88547,M. Jean Jacques MOREL,RN,11451,12.93,27.6,Qualif
97,01,41482,809,1134,43425,45122,88547,M. René-Paul VICTORIA,LR,5670,6.4,13.67,Battu
97,01,41482,809,1134,43425,45122,88547,M. Ludovic SAUTRON,ECO,2126,2.4,5.13,Battu
97,01,41482,809,1134,43425,45122,88547,Mme Gaëlle LEBON,REC,1693,1.91,4.08,Battu
97,01,41482,809,1134,43425,45122,88547,M. Gino PONIN BALLOM,DVD,699,0.79,1.69,Battu
97,01,41482,809,1134,43425,45122,88547,M. Paul TECHER,EXG,450,0.51,1.08,Battu
97,01,41482,809,1134,43425,45122,88547,Mme Nadine MITRA,DIV,148,0.17,0.36,Battu
97,01,41482,809,1134,43425,45122,88547,M. Krisna SAWOO,DIV,59,0.07,0.14,Battu
97,02,39957,1401,1504,42862,58881,101743,Mme Karine LEBON,UG,19068,18.74,47.72,Qualif
97,02,39957,1401,1504,42862,58881,101743,Mme Christelle BEGUE,RN,8513,8.37,21.31,Qualif
97,02,39957,1401,1504,42862,58881,101743,M. Erick FONTAINE,DIV,6406,6.3,16.03,Battu
97,02,39957,1401,1504,42862,58881,101743,M. Jean-Yves MOREL,DVD,3415,3.36,8.55,Battu
97,02,39957,1401,1504,42862,58881,101743,M. Claude MOUTOUALLAGUIN,REC,750,0.74,1.88,Battu
97,02,39957,1401,1504,42862,58881,101743,M. Alix MERA,DSV,699,0.69,1.75,Battu
97,02,39957,1401,1504,42862,58881,101743,Mme Nelly ACTIF,EXG,617,0.61,1.54,Battu
97,02,39957,1401,1504,42862,58881,101743,Mme Fabienne FALDON,DIV,489,0.48,1.22,Battu
97,03,42334,1529,1490,45353,53482,98835,M. Joseph RIVIERE,RN,13360,13.52,31.56,Qualif
97,03,42334,1529,1490,45353,53482,98835,M. Alexis CHAUSSALET,DVG,10076,10.19,23.8,Qualif
97,03,42334,1529,1490,45353,53482,98835,Mme Nathalie BASSIRE,DVD,9718,9.83,22.96,Battu
97,03,42334,1529,1490,45353,53482,98835,Mme Monique BENARD,DVD,4207,4.26,9.94,Battu
97,03,42334,1529,1490,45353,53482,98835,M. Jean Jacques VLODY,DVG,2121,2.15,5.01,Battu
97,03,42334,1529,1490,45353,53482,98835,M. Didier HOAREAU,EXD,2083,2.11,4.92,Battu
97,03,42334,1529,1490,45353,53482,98835,M. Nicolas LEGENTIL,EXG,540,0.55,1.28,Battu
97,03,42334,1529,1490,45353,53482,98835,M. Jean-Eric THEINE,DSV,229,0.23,0.54,Battu
97,03,42334,1529,1490,45353,53482,98835,M. Antoine FONTAINE,REG,0,0,0,Battu
97,04,53680,1718,1577,56975,54508,111483,Mme Emeline KBIDI,DVG,22696,20.36,42.28,Qualif
97,04,53680,1718,1577,56975,54508,111483,M. Jonathan RIVIERE,RN,14797,13.27,27.57,Qualif
97,04,53680,1718,1577,56975,54508,111483,M. David LORION,DVD,13171,11.81,24.54,Battu
97,04,53680,1718,1577,56975,54508,111483,M. Imrhane MOULLAN,DVD,1594,1.43,2.97,Battu
97,04,53680,1718,1577,56975,54508,111483,M. Serge LATCHOUMANIN,EXG,1189,1.07,2.21,Battu
97,04,53680,1718,1577,56975,54508,111483,Mme Martine DIJOUX,DSV,233,0.21,0.43,Battu
97,05,34768,1168,955,36891,53745,90636,M. Jean-Hugues RATENON,DVG,11536,12.73,33.18,Qualif
97,05,34768,1168,955,36891,53745,90636,M. Joan DORO,RN,10456,11.54,30.07,Qualif
97,05,34768,1168,955,36891,53745,90636,Mme Anne CHANE-KAYE-BONE,DVG,5757,6.35,16.56,Battu
97,05,34768,1168,955,36891,53745,90636,Mme Léopoldine SETTAMA-VIDON,DVC,3655,4.03,10.51,Battu
97,05,34768,1168,955,36891,53745,90636,M. Jean Yves PAYET,EXG,989,1.09,2.84,Battu
97,05,34768,1168,955,36891,53745,90636,M. Jérémy LAUP,DIV,800,0.88,2.3,Battu
97,05,34768,1168,955,36891,53745,90636,Mme Alexandrine DUCHEMANE ARAYE,DVG,443,0.49,1.27,Battu
97,05,34768,1168,955,36891,53745,90636,M. Jean Dominique RAMASSAMY,DVD,413,0.46,1.19,Battu
97,05,34768,1168,955,36891,53745,90636,M. Dominique SAUTRON,REC,300,0.33,0.86,Battu
97,05,34768,1168,955,36891,53745,90636,Mme Lydia PICARD,DIV,287,0.32,0.83,Battu
97,05,34768,1168,955,36891,53745,90636,M. Jean Paul LIMBE,DIV,132,0.15,0.38,Battu
97,06,36352,914,854,38120,46635,84755,M. Frédéric MAILLOT,DVG,10818,12.76,29.76,Qualif
97,06,36352,914,854,38120,46635,84755,Mme Valérie LEGROS,RN,9790,11.55,26.93,Qualif
97,06,36352,914,854,38120,46635,84755,M. Alexandre LAÏ-KANE-CHEONG,DVG,9083,10.72,24.99,Battu
97,06,36352,914,854,38120,46635,84755,Mme Nadia RAMASSAMY,ENS,3667,4.33,10.09,Battu
97,06,36352,914,854,38120,46635,84755,M. Mario LECHAT,DVD,1688,1.99,4.64,Battu
97,06,36352,914,854,38120,46635,84755,M. Johny ADEKALOM,DVC,581,0.69,1.6,Battu
97,06,36352,914,854,38120,46635,84755,M. Didier LOMBARD,EXG,475,0.56,1.31,Battu
97,06,36352,914,854,38120,46635,84755,Mme Marie Christine POUNIA,REC,250,0.29,0.69,Battu
97,07,50261,1792,1806,53859,67287,121146,M. Perceval GAILLARD,UG,14851,12.26,29.55,Qualif
97,07,50261,1792,1806,53859,67287,121146,M. Jean-Luc POUDROUX,RN,12853,10.61,25.57,Qualif
97,07,50261,1792,1806,53859,67287,121146,M. Thierry ROBERT,DVC,11083,9.15,22.05,Battu
97,07,50261,1792,1806,53859,67287,121146,M. Cyrille HAMILCARO,DVD,3754,3.1,7.47,Battu
97,07,50261,1792,1806,53859,67287,121146,M. Karim JUHOOR,DVG,2854,2.36,5.68,Battu
97,07,50261,1792,1806,53859,67287,121146,Mme Isaline TRONC,DVG,2651,2.19,5.27,Battu
97,07,50261,1792,1806,53859,67287,121146,M. Jean-Luc PAYET,EXG,724,0.6,1.44,Battu
97,07,50261,1792,1806,53859,67287,121146,Mme Nathalie DE BOISVILLIERS,REC,551,0.45,1.1,Battu
97,07,50261,1792,1806,53859,67287,121146,M. Richelain CATHERINE,DIV,479,0.4,0.95,Battu
97,07,50261,1792,1806,53859,67287,121146,Mme Sandrine MOUKINE,DSV,461,0.38,0.92,Battu
97,01,2748,22,37,2807,2262,5069,M. Stéphane LENORMAND,DVD,1184,23.36,43.09,Qualif
97,01,2748,22,37,2807,2262,5069,M. Frédéric BEAUMONT,SOC,464,9.15,16.89,Qualif
97,01,2748,22,37,2807,2262,5069,Mme Marion LETOURNEL,FI,409,8.07,14.88,Battu
97,01,2748,22,37,2807,2262,5069,M. Patrick LEBAILLY,DVG,400,7.89,14.56,Battu
97,01,2748,22,37,2807,2262,5069,Mme Patricia CHAGNON,RN,291,5.74,10.59,Battu
97,01,17162,543,417,18122,27538,45660,Mme Estelle YOUSSOUFFA,DVD,13640,29.87,79.48,Elu
97,01,17162,543,417,18122,27538,45660,M. Kambi Said SAID,DVD,2513,5.5,14.64,Battu
97,01,17162,543,417,18122,27538,45660,M. Mikhaël SAIFY,EXG,684,1.5,3.99,Battu
97,01,17162,543,417,18122,27538,45660,Mme Aurélia MAILLARD,REC,325,0.71,1.89,Battu
97,02,22396,1019,711,24126,28323,52449,Mme Anchya BAMANA,RN,7933,15.13,35.42,Qualif
97,02,22396,1019,711,24126,28323,52449,M. Mansour KAMARDINE,LR,6226,11.87,27.8,Qualif
97,02,22396,1019,711,24126,28323,52449,M. Soula SAÏD-SOUFFOU,DVC,3560,6.79,15.9,Battu
97,02,22396,1019,711,24126,28323,52449,M. Madi-Boinamani MADI MARI,DVC,3470,6.62,15.49,Battu
97,02,22396,1019,711,24126,28323,52449,M. Kira Bacar ADACOLO,DVG,552,1.05,2.46,Battu
97,02,22396,1019,711,24126,28323,52449,M. Daniel Martial HENRY,DVD,369,0.7,1.65,Battu
97,02,22396,1019,711,24126,28323,52449,Mme Manon MORENO,REC,164,0.31,0.73,Battu
97,02,22396,1019,711,24126,28323,52449,M. Ahumad SALIME,DIV,122,0.23,0.54,Battu
98,01,6877,38,49,6964,2067,9031,M. Mikaele SEO,ENS,4281,47.4,62.25,Elu
98,01,6877,38,49,6964,2067,9031,Mme Lavinia KANIMOA NÉE TAGANE,DVD,1248,13.82,18.15,Battu
98,01,6877,38,49,6964,2067,9031,Mme Lauriane TIALETAGI EPOUSE VERGE,DVC,1028,11.38,14.95,Battu
98,01,6877,38,49,6964,2067,9031,M. Otilone TOKOTUU,DVD,320,3.54,4.65,Battu
98,01,34271,204,277,34752,39024,73776,M. Moerani FREBAULT,DVD,18456,25.02,53.85,Elu
98,01,34271,204,277,34752,39024,73776,M. Tematai LE GAYIC,REG,12243,16.59,35.72,Battu
98,01,34271,204,277,34752,39024,73776,M. James HEAUX,RN,2168,2.94,6.33,Battu
98,01,34271,204,277,34752,39024,73776,M. Jacky BRYANT,ECO,1404,1.9,4.1,Battu
98,02,26454,171,208,26833,42412,69245,Mme Nicole SANQUER,DVD,12986,18.75,49.09,Qualif
98,02,26454,171,208,26833,42412,69245,M. Steve CHAILLOUX,REG,11162,16.12,42.19,Qualif
98,02,26454,171,208,26833,42412,69245,M. Tutu TETUANUI,RN,1240,1.79,4.69,Battu
98,02,26454,171,208,26833,42412,69245,M. Tati SALMON,ECO,1047,1.51,3.96,Battu
98,02,26454,171,208,26833,42412,69245,M. Jules Tehuiarii TARA,DVD,19,0.03,0.07,Battu
98,03,29226,226,349,29801,39227,69028,Mme Mereana REID ABERLOT,REG,12483,18.08,42.71,Qualif
98,03,29226,226,349,29801,39227,69028,Mme Pascale HAITI EPOUSE FLOSSE,DVD,12006,17.39,41.08,Qualif
98,03,29226,226,349,29801,39227,69028,Mme Naumi MIHURAA,DVD,3230,4.68,11.05,Battu
98,03,29226,226,349,29801,39227,69028,M. Jules HAUATA,ECO,1507,2.18,5.16,Battu
98,01,56050,394,472,56916,40247,97163,M. Nicolas METZDORF,DVD,22316,22.97,39.81,Qualif
98,01,56050,394,472,56916,40247,97163,Mme Omayra Lisa Meun NAISSELINE,REG,20370,20.96,36.34,Qualif
98,01,56050,394,472,56916,40247,97163,M. Philippe DUNOYER,HOR,5791,5.96,10.33,Battu
98,01,56050,394,472,56916,40247,97163,Mme Veylma FALAEO,DVG,2731,2.81,4.87,Battu
98,01,56050,394,472,56916,40247,97163,M. Simon LOUECKHOTE,RN,2562,2.64,4.57,Battu
98,01,56050,394,472,56916,40247,97163,Mme Muneiko HAOCAS,REG,1229,1.26,2.19,Battu
98,01,56050,394,472,56916,40247,97163,Mme Juanita Ciane ANGEXETINE ÉP RAILATI,REG,344,0.35,0.61,Battu
98,01,56050,394,472,56916,40247,97163,M. Cédric DEVAUD,ECO,235,0.24,0.42,Battu
98,01,56050,394,472,56916,40247,97163,M. Pierre-Henri CUENOT,DVD,173,0.18,0.31,Battu
98,01,56050,394,472,56916,40247,97163,M. Thomas NASRI,REC,158,0.16,0.28,Battu
98,01,56050,394,472,56916,40247,97163,Mme Germaine Toléta NEMIA ÉP BISHOP,REG,78,0.08,0.14,Battu
98,01,56050,394,472,56916,40247,97163,M. Manuel MILLAR,DIV,63,0.06,0.11,Battu
98,02,74738,605,1046,76389,48562,124951,M. Emmanuel TJIBAOU,REG,32926,26.35,44.06,Qualif
98,02,74738,605,1046,76389,48562,124951,M. Alcide PONGA,DVD,27038,21.64,36.18,Qualif
98,02,74738,605,1046,76389,48562,124951,M. Milakulo TUKUMULI,DVG,8906,7.13,11.92,Battu
98,02,74738,605,1046,76389,48562,124951,M. Gérard POADJA,HOR,3946,3.16,5.28,Battu
98,02,74738,605,1046,76389,48562,124951,M. Luther VOUDJO,REG,1114,0.89,1.49,Battu
98,02,74738,605,1046,76389,48562,124951,M. Ronald FRERE,REG,808,0.65,1.08,Battu
ZX,01,6919,99,214,7232,17995,25227,M. Frantz GUMBS,DVC,2867,11.36,41.44,Qualif
ZX,01,6919,99,214,7232,17995,25227,Mme Alexandra QUESTEL,DVD,1378,5.46,19.92,Qualif
ZX,01,6919,99,214,7232,17995,25227,M. Philippe PHILIDOR,DVD,1170,4.64,16.91,Battu
ZX,01,6919,99,214,7232,17995,25227,M. Clément CHAPDELAINE,REC,680,2.7,9.83,Battu
ZX,01,6919,99,214,7232,17995,25227,M. Ricardo BETHEL,DIV,399,1.58,5.77,Battu
ZX,01,6919,99,214,7232,17995,25227,M. Hervé MEUNIER,DIV,230,0.91,3.32,Battu
ZX,01,6919,99,214,7232,17995,25227,Mme Lila KRIMI,DIV,102,0.4,1.47,Battu
ZX,01,6919,99,214,7232,17995,25227,Mme Diane FELIX,DIV,93,0.37,1.34,Battu
ZZ,01,93630,90,1039,94759,171173,265932,M. Roland LESCURE,ENS,36363,13.67,38.84,Qualif
ZZ,01,93630,90,1039,94759,171173,265932,M. Oussama LARAICHI,UG,33822,12.72,36.12,Qualif
ZZ,01,93630,90,1039,94759,171173,265932,Mme Jennifer ADAM,RN,10018,3.77,10.7,Battu
ZZ,01,93630,90,1039,94759,171173,265932,M. Olivier PITON,LR,4856,1.83,5.19,Battu
ZZ,01,93630,90,1039,94759,171173,265932,Mme Véronique JACKSON,DVC,4643,1.75,4.96,Battu
ZZ,01,93630,90,1039,94759,171173,265932,M. Elias FORNERIS,DVD,1414,0.53,1.51,Battu
ZZ,01,93630,90,1039,94759,171173,265932,Mme Alexandra POURCHET,REC,1357,0.51,1.45,Battu
ZZ,01,93630,90,1039,94759,171173,265932,M. Greg LACOSTE,DIV,1090,0.41,1.16,Battu
ZZ,01,93630,90,1039,94759,171173,265932,Mme Paloma LADAM,DVG,67,0.03,0.07,Battu
ZZ,02,19227,59,233,19519,62274,81793,M. Sergio CORONADO,UG,6952,8.5,36.16,Qualif
ZZ,02,19227,59,233,19519,62274,81793,Mme Eléonore CAROIT,ENS,6440,7.87,33.49,Qualif
ZZ,02,19227,59,233,19519,62274,81793,Mme Marie-Nathalie GONCALVES,RN,2553,3.12,13.28,Battu
ZZ,02,19227,59,233,19519,62274,81793,M. Bertrand DUPONT,LR,1905,2.33,9.91,Battu
ZZ,02,19227,59,233,19519,62274,81793,Mme Jessica AGOSTINI,DVC,987,1.21,5.13,Battu
ZZ,02,19227,59,233,19519,62274,81793,Mme Nora COURMONTAGNE,REC,373,0.46,1.94,Battu
ZZ,02,19227,59,233,19519,62274,81793,Mme Camille MERCIER,DIV,17,0.02,0.09,Battu
ZZ,03,68515,112,829,69456,91178,160634,Mme Charlotte MINVIELLE,UG,26873,16.73,39.22,Qualif
ZZ,03,68515,112,829,69456,91178,160634,M. Vincent CAURE,ENS,26810,16.69,39.13,Qualif
ZZ,03,68515,112,829,69456,91178,160634,Mme Sophie CHARBONNET,RN,4504,2.8,6.57,Battu
ZZ,03,68515,112,829,69456,91178,160634,Mme Balthazar ROGER,LR,3442,2.14,5.02,Battu
ZZ,03,68515,112,829,69456,91178,160634,Mme Assamahou LAMARRE,DVC,3365,2.09,4.91,Battu
ZZ,03,68515,112,829,69456,91178,160634,M. Joel HESLAUT,DVC,1251,0.78,1.83,Battu
ZZ,03,68515,112,829,69456,91178,160634,M. Anthony COUTRET,REC,752,0.47,1.1,Battu
ZZ,03,68515,112,829,69456,91178,160634,M. Tanguy PINOMAA-DANZÉ,DVG,701,0.44,1.02,Battu
ZZ,03,68515,112,829,69456,91178,160634,M. Emmanuel CONSTANTIN,ECO,355,0.22,0.52,Battu
ZZ,03,68515,112,829,69456,91178,160634,M. Tim CRAYE,DVD,236,0.15,0.34,Battu
ZZ,03,68515,112,829,69456,91178,160634,M. Yvan BACHAUD,DIV,226,0.14,0.33,Battu
ZZ,04,74485,99,713,75297,82742,158039,Mme Cécilia GONDARD,UG,27898,17.65,37.45,Qualif
ZZ,04,74485,99,713,75297,82742,158039,M. Pieyre-Alexandre ANGLADE,ENS,26410,16.71,35.46,Qualif
ZZ,04,74485,99,713,75297,82742,158039,Mme Charlotte BEAUFILS,RN,6736,4.26,9.04,Battu
ZZ,04,74485,99,713,75297,82742,158039,Mme Genevieve MACHICOTE,LR,4604,2.91,6.18,Battu
ZZ,04,74485,99,713,75297,82742,158039,Mme Juliette DE CAUSANS,DVC,4318,2.73,5.8,Battu
ZZ,04,74485,99,713,75297,82742,158039,M. Sacha COURTIAL,DVG,1563,0.99,2.1,Battu
ZZ,04,74485,99,713,75297,82742,158039,M. Patrick BRISSET,DVD,1492,0.94,2,Battu
ZZ,04,74485,99,713,75297,82742,158039,Mme Anne-Catherine GIRARD,REC,1001,0.63,1.34,Battu
ZZ,04,74485,99,713,75297,82742,158039,Mme Aude ROSSOLINI,DIV,463,0.29,0.62,Battu
ZZ,05,43031,70,591,43692,71810,115502,M. Stéphane VOJETTA,DVC,14492,12.55,33.68,Qualif
ZZ,05,43031,70,591,43692,71810,115502,M. Maxime DA SILVA,UG,11267,9.75,26.18,Qualif
ZZ,05,43031,70,591,43692,71810,115502,Mme Johana MAUREL,RN,8385,7.26,19.49,Battu
ZZ,05,43031,70,591,43692,71810,115502,M. José SANCHEZ PEREZ,DVC,2226,1.93,5.17,Battu
ZZ,05,43031,70,591,43692,71810,115502,M. Jeremie FOSSE,DVG,2161,1.87,5.02,Battu
ZZ,05,43031,70,591,43692,71810,115502,M. Yohann CASTRO,DVD,2069,1.79,4.81,Battu
ZZ,05,43031,70,591,43692,71810,115502,Mme Béatrice MAZEL,REC,794,0.69,1.85,Battu
ZZ,05,43031,70,591,43692,71810,115502,Mme Sarah MILLOT,DVG,587,0.51,1.36,Battu
ZZ,05,43031,70,591,43692,71810,115502,M. Alexandre MARIE,DVG,353,0.31,0.82,Battu
ZZ,05,43031,70,591,43692,71810,115502,M. Jean-François CALVET,DSV,308,0.27,0.72,Battu
ZZ,05,43031,70,591,43692,71810,115502,Mme Maud LAGARDE,DIV,187,0.16,0.43,Battu
ZZ,05,43031,70,591,43692,71810,115502,M. Christopher BRENIER,DIV,132,0.11,0.31,Battu
ZZ,05,43031,70,591,43692,71810,115502,M. David NATAF,DIV,70,0.06,0.16,Battu
ZZ,06,63122,88,588,63798,95948,159746,M. Marc FERRACCI,ENS,25590,16.02,40.54,Qualif
ZZ,06,63122,88,588,63798,95948,159746,Mme Halima DELIMI,UG,19446,12.17,30.81,Qualif
ZZ,06,63122,88,588,63798,95948,159746,Mme Déborah MERCERON,RN,9158,5.73,14.51,Battu
ZZ,06,63122,88,588,63798,95948,159746,M. Olivier CORTICCHIATO,LR,4172,2.61,6.61,Battu
ZZ,06,63122,88,588,63798,95948,159746,M. Jacques DE CAUSANS,DVC,1888,1.18,2.99,Battu
ZZ,06,63122,88,588,63798,95948,159746,M. Philippe TISSOT,REC,949,0.59,1.5,Battu
ZZ,06,63122,88,588,63798,95948,159746,Mme Marie-Julie JACQUEMOT,DVG,651,0.41,1.03,Battu
ZZ,06,63122,88,588,63798,95948,159746,M. Arnaud DORTHE,DIV,627,0.39,0.99,Battu
ZZ,06,63122,88,588,63798,95948,159746,Mme Céline VON AUW,ECO,419,0.26,0.66,Battu
ZZ,06,63122,88,588,63798,95948,159746,Mme Michèle SELLES LEFRANC,RDG,222,0.14,0.35,Battu
ZZ,07,58050,81,428,58559,72265,130824,M. Frédéric PETIT,ENS,21929,16.76,37.78,Qualif
ZZ,07,58050,81,428,58559,72265,130824,Mme Asma RHARMAOUI-CLAQUIN,UG,18914,14.46,32.58,Qualif
ZZ,07,58050,81,428,58559,72265,130824,Mme Mathilde NAVEYS--DUMAS,RN,4520,3.46,7.79,Battu
ZZ,07,58050,81,428,58559,72265,130824,Mme Isabelle HUQUET,DVC,3861,2.95,6.65,Battu
ZZ,07,58050,81,428,58559,72265,130824,Mme Cécile RICHARD,DVG,3211,2.45,5.53,Battu
ZZ,07,58050,81,428,58559,72265,130824,Mme Dominique MIER-GARRIGOU,LR,2702,2.07,4.65,Battu
ZZ,07,58050,81,428,58559,72265,130824,M. Jérôme CHAMBON,DIV,1948,1.49,3.36,Battu
ZZ,07,58050,81,428,58559,72265,130824,Mme Julie ALEXANDRE,REC,720,0.55,1.24,Battu
ZZ,07,58050,81,428,58559,72265,130824,Mme Fanny GEFFRAY,DIV,245,0.19,0.42,Battu
ZZ,08,32482,85,503,33070,115887,148957,M. Meyer HABIB,LR,11557,7.76,35.58,Qualif
ZZ,08,32482,85,503,33070,115887,148957,Mme Caroline YADAN,ENS,7855,5.27,24.18,Qualif
ZZ,08,32482,85,503,33070,115887,148957,Mme Yaël LERER,UG,7516,5.05,23.14,Battu
ZZ,08,32482,85,503,33070,115887,148957,M. Guillaume BENSOUSSAN,REC,2044,1.37,6.29,Battu
ZZ,08,32482,85,503,33070,115887,148957,Mme Aurelie ASSOULINE,LR,1329,0.89,4.09,Battu
ZZ,08,32482,85,503,33070,115887,148957,M. Gilles NEFFATI,DVC,1025,0.69,3.16,Battu
ZZ,08,32482,85,503,33070,115887,148957,Mme Valérie CHARTRAIN,DVG,457,0.31,1.41,Battu
ZZ,08,32482,85,503,33070,115887,148957,M. Nicolas SPITALAS,DIV,299,0.2,0.92,Battu
ZZ,08,32482,85,503,33070,115887,148957,M. Philippe HABABOU SOLOMON,DVD,197,0.13,0.61,Battu
ZZ,08,32482,85,503,33070,115887,148957,M. David BIZET,DIV,188,0.13,0.58,Battu
ZZ,08,32482,85,503,33070,115887,148957,M. Benjamin SIGOURA,DIV,15,0.01,0.05,Battu
ZZ,09,35880,131,592,36603,93784,130387,M. Karim BEN CHEÏKH,UG,18505,14.19,51.57,Qualif
ZZ,09,35880,131,592,36603,93784,130387,Mme Samira DJOUADI,ENS,5634,4.32,15.7,Qualif
ZZ,09,35880,131,592,36603,93784,130387,Mme Elodie CHARRON,RN,3817,2.93,10.64,Battu
ZZ,09,35880,131,592,36603,93784,130387,M. Ismaël BOUDJEKADA,DVG,1421,1.09,3.96,Battu
ZZ,09,35880,131,592,36603,93784,130387,M. Jihad BADREDDINE,LR,1242,0.95,3.46,Battu
ZZ,09,35880,131,592,36603,93784,130387,M. Erwan Borhan DAVOUX,DVD,1222,0.94,3.41,Battu
ZZ,09,35880,131,592,36603,93784,130387,M. Seddik KHALFI,DVG,1171,0.9,3.26,Battu
ZZ,09,35880,131,592,36603,93784,130387,M. Rachid TAHIRI,DVC,1102,0.85,3.07,Battu
ZZ,09,35880,131,592,36603,93784,130387,Mme Régina DUCELLIER,DVC,693,0.53,1.93,Battu
ZZ,09,35880,131,592,36603,93784,130387,M. Pierre DREVON,REC,311,0.24,0.87,Battu
ZZ,09,35880,131,592,36603,93784,130387,M. Hassan OUDRHIRI,DIV,236,0.18,0.66,Battu
ZZ,09,35880,131,592,36603,93784,130387,M. Sébastien PERIMONY,DIV,172,0.13,0.48,Battu
ZZ,09,35880,131,592,36603,93784,130387,Mme Kourtoum SACKHO,DVD,117,0.09,0.33,Battu
ZZ,09,35880,131,592,36603,93784,130387,M. Gabriel Marie SIDIBÉ,DIV,84,0.06,0.23,Battu
ZZ,09,35880,131,592,36603,93784,130387,Mme Rania Tessa MAACHOU,DIV,61,0.05,0.17,Battu
ZZ,09,35880,131,592,36603,93784,130387,M. Hachim FADILI,DSV,53,0.04,0.15,Battu
ZZ,09,35880,131,592,36603,93784,130387,M. Edouard TINAUGUS,DVG,20,0.02,0.06,Battu
ZZ,09,35880,131,592,36603,93784,130387,Mme Khadija DAVID,DVG,11,0.01,0.03,Battu
ZZ,09,35880,131,592,36603,93784,130387,M. Abdoulai DIANIFABA,DIV,8,0.01,0.02,Battu
ZZ,10,35824,115,563,36502,77353,113855,Mme Elsa DI MEO,UG,11651,10.23,32.52,Qualif
ZZ,10,35824,115,563,36502,77353,113855,Mme Amélia LAKRAFI,ENS,11398,10.01,31.82,Qualif
ZZ,10,35824,115,563,36502,77353,113855,M. Jean DE VERON,UXD,6147,5.4,17.16,Battu
ZZ,10,35824,115,563,36502,77353,113855,M. Lucas LAMAH,LR,3488,3.06,9.74,Battu
ZZ,10,35824,115,563,36502,77353,113855,Mme Marie Josée MABASI,DVC,948,0.83,2.65,Battu
ZZ,10,35824,115,563,36502,77353,113855,M. Philippe CASTELLAN,REC,842,0.74,2.35,Battu
ZZ,10,35824,115,563,36502,77353,113855,M. Ali Camille HOJEIJ,DVC,709,0.62,1.98,Battu
ZZ,10,35824,115,563,36502,77353,113855,Mme Odile MOJON-CHEMINADE,DIV,450,0.4,1.26,Battu
ZZ,10,35824,115,563,36502,77353,113855,Mme Sandra LAROSE,DIV,94,0.08,0.26,Battu
ZZ,10,35824,115,563,36502,77353,113855,Mme Julie LAGUI,DIV,70,0.06,0.2,Battu
ZZ,10,35824,115,563,36502,77353,113855,M. Hugues Michel MARIE-LOUISE,DIV,20,0.02,0.06,Battu
ZZ,10,35824,115,563,36502,77353,113855,Mme Nathalie MAZOT,DVG,7,0.01,0.02,Battu
ZZ,11,41986,91,618,42695,61924,104619,Mme Anne GENETET,ENS,16770,16.03,39.94,Qualif
ZZ,11,41986,91,618,42695,61924,104619,M. Franck PAJOT,UG,12502,11.95,29.78,Qualif
ZZ,11,41986,91,618,42695,61924,104619,M. Pierre BROCHET,RN,6424,6.14,15.3,Battu
ZZ,11,41986,91,618,42695,61924,104619,M. Marc GUYON,EXD,1495,1.43,3.56,Battu
ZZ,11,41986,91,618,42695,61924,104619,M. François ASSELINEAU,DSV,1376,1.32,3.28,Battu
ZZ,11,41986,91,618,42695,61924,104619,Mme Tatiana BOTEVA-MALO,ECO,949,0.91,2.26,Battu
ZZ,11,41986,91,618,42695,61924,104619,Mme Anne-France LARQUEMIN,REC,719,0.69,1.71,Battu
ZZ,11,41986,91,618,42695,61924,104619,M. Jordan CRUCIANI,ECO,574,0.55,1.37,Battu
ZZ,11,41986,91,618,42695,61924,104619,Mme Françoise ARTHUR,REG,507,0.48,1.21,Battu
ZZ,11,41986,91,618,42695,61924,104619,Mme Elise PHONRATH,DSV,244,0.23,0.58,Battu
ZZ,11,41986,91,618,42695,61924,104619,M. Jacques CHEMINADE,DIV,224,0.21,0.53,Battu
ZZ,11,41986,91,618,42695,61924,104619,Mme Nelly VIOLETTE,DIV,148,0.14,0.35,Battu
ZZ,11,41986,91,618,42695,61924,104619,M. Victor MAUREL,DIV,30,0.03,0.07,Battu
ZZ,11,41986,91,618,42695,61924,104619,Mme Nathalie MARTIN,DVG,14,0.01,0.03,Battu
ZZ,11,41986,91,618,42695,61924,104619,M. Olivier MACHET,DIV,10,0.01,0.02,Battu
